AAAAAACCGAT -> AAAAACCGATT
AAAAACCGATT -> AAAACCGATTT
AAAACCGATTT -> AAACCGATTTG
AAAAGCAACAG -> AAAGCAACAGT
AAAAGTGGTCG -> AAAGTGGTCGT
AAACACAAAGA -> AACACAAAGAT
AAACACTATCA -> AACACTATCAA
AAACCGATTTG -> AACCGATTTGG
AAACCGGTTCG -> AACCGGTTCGG
AAACGCCACGA -> AACGCCACGAA
AAACTCTTCCC -> AACTCTTCCCT
AAAGACATCGC -> AAGACATCGCG
AAAGACGACTC -> AAGACGACTCA
AAAGATCTTAT -> AAGATCTTATC
AAAGCAACAGT -> AAGCAACAGTT
AAAGCGAAATG -> AAGCGAAATGG
AAAGGAAGGCG -> AAGGAAGGCGC
AAAGGAATCTG -> AAGGAATCTGC
AAAGGTAGCGG -> AAGGTAGCGGC
AAAGTGGTCGT -> AAGTGGTCGTC
AAATAGGGCTT -> AATAGGGCTTC
AAATGGCATCA -> AATGGCATCAC
AAATTATGTGT -> AATTATGTGTG
AACAAAAAACC -> ACAAAAAACCG
AACAAAGACAT -> ACAAAGACATC
AACACAAAGAT -> ACACAAAGATC
AACACTATCAA -> ACACTATCAAT
AACAGATCTTA -> ACAGATCTTAT
AACAGGACTTG -> ACAGGACTTGT
AACAGTCGAAG -> ACAGTCGAAGC
AACAGTTTTAC -> ACAGTTTTACA
AACATCCACGC -> ACATCCACGCC
AACATGGTGAA -> ACATGGTGAAT
AACCAGGTAAC -> ACCAGGTAACC
AACCATAGGGC -> ACCATAGGGCT
AACCCATTTCC -> ACCCATTTCCT
AACCCGACTGG -> ACCCGACTGGG
AACCCGGCGCG -> ACCCGGCGCGA
AACCGATTTGG -> ACCGATTTGGC
AACCGGTTCGG -> ACCGGTTCGGT
AACCTAACATC -> ACCTAACATCC
AACCTATTTAT -> ACCTATTTATG
AACGAAACGCC -> ACGAAACGCCA
AACGCCACGAA -> ACGCCACGAAG
AACGCCCATGC -> ACGCCCATGCT
AACGGTTACCA -> ACGGTTACCAA
AACTACCTCGG -> ACTACCTCGGA
AACTAGTCGAC -> ACTAGTCGACA
AACTCCTTTAC -> ACTCCTTTACT
AACTCTAGGAG -> ACTCTAGGAGT
AACTCTCAGGC -> ACTCTCAGGCC
AACTCTTCCCT -> ACTCTTCCCTT
AACTGACATCT -> ACTGACATCTA
AACTGCCGATG -> ACTGCCGATGA
AACTTCGGCTC -> ACTTCGGCTCA
AACTTTTAGAC -> ACTTTTAGACC
AAGACATCGCG -> AGACATCGCGC
AAGACCATTAA -> AGACCATTAAT
AAGACGACTCA -> AGACGACTCAA
AAGAGAATCTT -> AGAGAATCTTA
AAGAGCGATAT -> AGAGCGATATG
AAGAGGTTTGC -> AGAGGTTTGCG
AAGAGTGACGG -> AGAGTGACGGC
AAGAGTGTAGA -> AGAGTGTAGAC
AAGATCTTATC -> AGATCTTATCC
AAGATGTTTGC -> AGATGTTTGCT
AAGATTAGGTT -> AGATTAGGTTT
AAGCAACAGTT -> AGCAACAGTTT
AAGCATAGTCC -> AGCATAGTCCA
AAGCATATCCC -> AGCATATCCCC
AAGCCGATTCT -> AGCCGATTCTA
AAGCCGGATGG -> AGCCGGATGGG
AAGCGAAATGG -> AGCGAAATGGC
AAGCGATTAAA -> AGCGATTAAAC
AAGGAAGGCGC -> AGGAAGGCGCA
AAGGAATCTGC -> AGGAATCTGCT
AAGGACAAGAG -> AGGACAAGAGT
AAGGCGCATGT -> AGGCGCATGTA
AAGGGTTACAT -> AGGGTTACATT
AAGGTACGTAG -> AGGTACGTAGA
AAGGTAGCGGC -> AGGTAGCGGCA
AAGTAAGGGTT -> AGTAAGGGTTA
AAGTAGCACAT -> AGTAGCACATA
AAGTGGTCGTC -> AGTGGTCGTCG
AAGTTAATAGC -> AGTTAATAGCC
AAGTTAGTCAT -> AGTTAGTCATT
AAGTTCATGCC -> AGTTCATGCCA
AATAACAGGAC -> ATAACAGGACT
AATAACCTATT -> ATAACCTATTT
AATACTGGTGT -> ATACTGGTGTC
AATAGATCCTG -> ATAGATCCTGA
AATAGCCCAAT -> ATAGCCCAATC
AATAGCTCTTC -> ATAGCTCTTCT
AATAGGGCTTC -> ATAGGGCTTCG
AATATTAACCC -> ATATTAACCCG
AATATTGTATC -> ATATTGTATCG
AATCAAGAGTG -> ATCAAGAGTGA
AATCTACCAGC -> ATCTACCAGCG
AATCTACCTAG -> ATCTACCTAGT
AATCTCGCTTT -> ATCTCGCTTTG
AATCTCTGTCT -> ATCTCTGTCTT
AATCTGCTGGA -> ATCTGCTGGAC
AATCTTATAGC -> ATCTTATAGCC
AATGAAGAGCG -> ATGAAGAGCGA
AATGACCTAGT -> ATGACCTAGTC
AATGATGGTGC -> ATGATGGTGCG
AATGCTTTAGC -> ATGCTTTAGCC
AATGGCATCAC -> ATGGCATCACG
AATGGTGTTGG -> ATGGTGTTGGA
AATGTGCGTCT -> ATGTGCGTCTT
AATGTTGCCCG -> ATGTTGCCCGG
AATTATAGCTA -> ATTATAGCTAT
AATTATGTGTG -> ATTATGTGTGG
AATTCAAAGAC -> ATTCAAAGACG
ACAAAAAACCG -> CAAAAAACCGA
ACAAACACAAA -> CAAACACAAAG
ACAAAGACATC -> CAAAGACATCG
ACAAAGATCTT -> CAAAGATCTTA
ACAACATGGTG -> CAACATGGTGA
ACAAGAGTGTA -> CAAGAGTGTAG
ACAAGATTAGG -> CAAGATTAGGT
ACAAGTTAATA -> CAAGTTAATAG
ACAATAACAGG -> CAATAACAGGA
ACAATATTAAC -> CAATATTAACC
ACACAAAGATC -> CACAAAGATCT
ACACACGGAGG -> CACACGGAGGA
ACACAGGCAGT -> CACAGGCAGTC
ACACCCGTGGC -> CACCCGTGGCG
ACACGCGGACG -> CACGCGGACGC
ACACGGAGGAC -> CACGGAGGACA
ACACTATAACA -> CACTATAACAG
ACACTATCAAT -> CACTATCAATT
ACAGAGACAAC -> CAGAGACAACA
ACAGATCTTAT -> CAGATCTTATT
ACAGCCACCTT -> CAGCCACCTTA
ACAGCCCCTTC -> CAGCCCCTTCA
ACAGCCGGGCC -> CAGCCGGGCCG
ACAGGACTTGT -> CAGGACTTGTA
ACAGGCAGTCA -> CAGGCAGTCAG
ACAGGCCTTGA -> CAGGCCTTGAC
ACAGGTACATG -> CAGGTACATGA
ACAGTCGAAGC -> CAGTCGAAGCG
ACAGTTGACTG -> CAGTTGACTGC
ACAGTTTTACA -> CAGTTTTACAT
ACATAGCTTGC -> CATAGCTTGCT
ACATCCACGCC -> CATCCACGCCC
ACATCGCCCAA -> CATCGCCCAAC
ACATCGCCCAT -> CATCGCCCATT
ACATCGCGCCG -> CATCGCGCCGT
ACATCGCTCTG -> CATCGCTCTGG
ACATCTATTCG -> CATCTATTCGG
ACATCTCGCTT -> CATCTCGCTTC
ACATGAGTACT -> CATGAGTACTT
ACATGGTGAAT -> CATGGTGAATA
ACATTGAGTCC -> CATTGAGTCCT
ACCAAACACTA -> CCAAACACTAT
ACCAAGCCGGA -> CCAAGCCGGAT
ACCAATCAAGA -> CCAATCAAGAG
ACCACCCGATG -> CCACCCGATGG
ACCAGCGCAGA -> CCAGCGCAGAT
ACCAGGTAACC -> CCAGGTAACCT
ACCATAGGGCT -> CCATAGGGCTG
ACCATGCATCG -> CCATGCATCGG
ACCATTAATGG -> CCATTAATGGT
ACCCATTTCCT -> CCCATTTCCTC
ACCCGACTGGG -> CCCGACTGGGA
ACCCGAGTCCA -> CCCGAGTCCAC
ACCCGATGGGA -> CCCGATGGGAC
ACCCGCCTTTG -> CCCGCCTTTGA
ACCCGGACAGC -> CCCGGACAGCC
ACCCGGCGCGA -> CCCGGCGCGAG
ACCCGTGGCGC -> CCCGTGGCGCG
ACCCTATATAG -> CCCTATATAGT
ACCCTTGATTA -> CCCTTGATTAC
ACCGAAATTAT -> CCGAAATTATG
ACCGATAATTA -> CCGATAATTAT
ACCGATTTGGC -> CCGATTTGGCT
ACCGGCTGTCA -> CCGGCTGTCAT
ACCGGTTACAC -> CCGGTTACACC
ACCGGTTCGGT -> CCGGTTCGGTC
ACCTAACATCC -> CCTAACATCCA
ACCTACACACG -> CCTACACACGG
ACCTACGGGCT -> CCTACGGGCTA
ACCTAGTCACA -> CCTAGTCACAA
ACCTAGTCTTG -> CCTAGTCTTGG
ACCTATTTATG -> CCTATTTATGT
ACCTCGGAACA -> CCTCGGAACAA
ACCTCGTAGTC -> CCTCGTAGTCT
ACCTTAATGTG -> CCTTAATGTGC
ACGAAACGCCA -> CGAAACGCCAC
ACGAACTCTAG -> CGAACTCTAGG
ACGAAGACCAT -> CGAAGACCATT
ACGAAGCATAT -> CGAAGCATATC
ACGACCCTTGA -> CGACCCTTGAT
ACGACTCAAGG -> CGACTCAAGGT
ACGACTTCGTA -> CGACTTCGTAA
ACGAGATGTAA -> CGAGATGTAAT
ACGAGCTAATA -> CGAGCTAATAG
ACGATACCCTA -> CGATACCCTAT
ACGATCAACTC -> CGATCAACTCC
ACGCCACAGGC -> CGCCACAGGCC
ACGCCACGAAG -> CGCCACGAAGC
ACGCCAGGTAG -> CGCCAGGTAGC
ACGCCAGTGCT -> CGCCAGTGCTC
ACGCCCATGCT -> CGCCCATGCTG
ACGCCCTAGCG -> CGCCCTAGCGT
ACGCCCTGTGG -> CGCCCTGTGGA
ACGCGGACGCC -> CGCGGACGCCC
ACGCGTATAAT -> CGCGTATAATG
ACGGAGGACAA -> CGGAGGACAAG
ACGGCTTGCAG -> CGGCTTGCAGA
ACGGGAGGATA -> CGGGAGGATAG
ACGGGCCATGG -> CGGGCCATGGT
ACGGGCTAGCT -> CGGGCTAGCTA
ACGGTTACCAA -> CGGTTACCAAT
ACGTAGACGCC -> CGTAGACGCCA
ACGTCCCGGTC -> CGTCCCGGTCA
ACGTCTCGTTT -> CGTCTCGTTTA
ACGTGAACCAG -> CGTGAACCAGG
ACTACCTCGGA -> CTACCTCGGAA
ACTAGAGTCCT -> CTAGAGTCCTA
ACTAGTCGACA -> CTAGTCGACAC
ACTATAACAGT -> CTATAACAGTC
ACTATCAATTC -> CTATCAATTCA
ACTCAAGGTAC -> CTCAAGGTACG
ACTCACGGGAG -> CTCACGGGAGG
ACTCCGGGGTC -> CTCCGGGGTCC
ACTCCTTTACT -> CTCCTTTACTC
ACTCTAGGAGT -> CTCTAGGAGTC
ACTCTCAGGCC -> CTCTCAGGCCT
ACTCTTCCCTT -> CTCTTCCCTTT
ACTGACATCTA -> CTGACATCTAT
ACTGCATCGGC -> CTGCATCGGCG
ACTGCCGATGA -> CTGCCGATGAG
ACTGCTCGTCT -> CTGCTCGTCTA
ACTGGGATACG -> CTGGGATACGT
ACTGGTAACTT -> CTGGTAACTTC
ACTGGTGTCCG -> CTGGTGTCCGC
ACTTACTTCAC -> CTTACTTCACG
ACTTCACGCGT -> CTTCACGCGTA
ACTTCCAGATG -> CTTCCAGATGC
ACTTCGGCTCA -> CTTCGGCTCAA
ACTTCGTAACC -> CTTCGTAACCC
ACTTGCTCACA -> CTTGCTCACAC
ACTTGTACGAA -> CTTGTACGAAC
ACTTTTAGACC -> CTTTTAGACCT
AGAAGAGGTTT -> GAAGAGGTTTG
AGAATATTGTA -> GAATATTGTAT
AGAATCTTATA -> GAATCTTATAG
AGACAACATGG -> GACAACATGGT
AGACAGTTGAC -> GACAGTTGACT
AGACATCGCGC -> GACATCGCGCC
AGACCACCCGA -> GACCACCCGAT
AGACCATTAAT -> GACCATTAATG
AGACCCGAGTC -> GACCCGAGTCC
AGACCTACACA -> GACCTACACAC
AGACGACTCAA -> GACGACTCAAG
AGACGCCACAG -> GACGCCACAGG
AGACGGGCCAT -> GACGGGCCATG
AGACTTCCAGA -> GACTTCCAGAT
AGAGAATCTTA -> GAGAATCTTAT
AGAGACAACAT -> GAGACAACATG
AGAGCCACAAG -> GAGCCACAAGT
AGAGCGATATG -> GAGCGATATGA
AGAGCTGTTTG -> GAGCTGTTTGA
AGAGGTTTGCG -> GAGGTTTGCGC
AGAGTCCTATC -> GAGTCCTATCG
AGAGTGACGGC -> GAGTGACGGCT
AGAGTGTAGAC -> GAGTGTAGACC
AGATATTCACC -> GATATTCACCG
AGATCCACCTC -> GATCCACCTCG
AGATCCGACAG -> GATCCGACAGC
AGATCCTGAAC -> GATCCTGAACT
AGATCTTATCC -> GATCTTATCCC
AGATCTTATTA -> GATCTTATTAT
AGATGCGGGCT -> GATGCGGGCTC
AGATGTAATGA -> GATGTAATGAA
AGATGTCAGTG -> GATGTCAGTGC
AGATGTTTGCT -> GATGTTTGCTA
AGATTAGGTTT -> GATTAGGTTTC
AGCAACAGTTT -> GCAACAGTTTT
AGCACATAGCT -> GCACATAGCTT
AGCACGCCAGG -> GCACGCCAGGT
AGCAGGAGGTC -> GCAGGAGGTCT
AGCAGGATCAA -> GCAGGATCAAA
AGCATAGTCCA -> GCATAGTCCAC
AGCATATCCCC -> GCATATCCCCG
AGCATCTTGCG -> GCATCTTGCGG
AGCATGAGGAA -> GCATGAGGAAC
AGCCACAAGTT -> GCCACAAGTTA
AGCCACCTTAA -> GCCACCTTAAT
AGCCCAATCTA -> GCCCAATCTAC
AGCCCACCATG -> GCCCACCATGC
AGCCCCGAAGT -> GCCCCGAAGTT
AGCCCCTTCAA -> GCCCCTTCAAG
AGCCCCTTGTG -> GCCCCTTGTGC
AGCCGATTCTA -> GCCGATTCTAT
AGCCGGATGGG -> GCCGGATGGGT
AGCCGGGCCGC -> GCCGGGCCGCG
AGCGAAATGGC -> GCGAAATGGCA
AGCGATATGAA -> GCGATATGAAT
AGCGATTAAAC -> GCGATTAAACC
AGCGCAGATCC -> GCGCAGATCCA
AGCGGCAGGCT -> GCGGCAGGCTC
AGCGTGGATGA -> GCGTGGATGAA
AGCTAACGCCC -> GCTAACGCCCA
AGCTAATAGCT -> GCTAATAGCTC
AGCTACTCACG -> GCTACTCACGG
AGCTATACATC -> GCTATACATCG
AGCTATCGAAT -> GCTATCGAATA
AGCTCGTGACA -> GCTCGTGACAA
AGCTCTTCTGC -> GCTCTTCTGCG
AGCTGTTTGAA -> GCTGTTTGAAA
AGCTTGCTCAG -> GCTTGCTCAGT
AGGAACCCGGC -> GGAACCCGGCG
AGGAAGGCGCA -> GGAAGGCGCAT
AGGAATCTGCT -> GGAATCTGCTG
AGGACAAGAGT -> GGACAAGAGTG
AGGACAAGATT -> GGACAAGATTA
AGGACTTGTAC -> GGACTTGTACG
AGGAGGCGGGA -> GGAGGCGGGAT
AGGAGGTCTTC -> GGAGGTCTTCG
AGGAGTCTTCA -> GGAGTCTTCAA
AGGATAGGGCG -> GGATAGGGCGG
AGGATCAAAGC -> GGATCAAAGCG
AGGCAGTCAGT -> GGCAGTCAGTC
AGGCATTTACC -> GGCATTTACCG
AGGCCTGTACC -> GGCCTGTACCT
AGGCCTTGACG -> GGCCTTGACGT
AGGCGCATGTA -> GGCGCATGTAT
AGGCGGGATTT -> GGCGGGATTTG
AGGCTACGAAG -> GGCTACGAAGA
AGGCTCAGCAG -> GGCTCAGCAGG
AGGGCGGCGGA -> GGGCGGCGGAA
AGGGCTGAGGG -> GGGCTGAGGGG
AGGGCTTCGGA -> GGGCTTCGGAA
AGGGGCTTATA -> GGGGCTTATAT
AGGGTTAATGA -> GGGTTAATGAT
AGGGTTACATT -> GGGTTACATTG
AGGTAACCTAA -> GGTAACCTAAC
AGGTACATGAG -> GGTACATGAGT
AGGTACGTAGA -> GGTACGTAGAC
AGGTAGCGGCA -> GGTAGCGGCAG
AGGTAGCTAAC -> GGTAGCTAACG
AGGTCTTACAC -> GGTCTTACACT
AGGTCTTCGCG -> GGTCTTCGCGG
AGGTTCTGGGG -> GGTTCTGGGGC
AGGTTTCTGAA -> GGTTTCTGAAA
AGGTTTGCGCG -> GGTTTGCGCGA
AGTAAAAGCAA -> GTAAAAGCAAC
AGTAAGGGTTA -> GTAAGGGTTAC
AGTACTTGCTC -> GTACTTGCTCA
AGTAGAAGAGG -> GTAGAAGAGGT
AGTAGCACATA -> GTAGCACATAG
AGTCACAATAT -> GTCACAATATT
AGTCAGCTCGT -> GTCAGCTCGTG
AGTCAGTCTGT -> GTCAGTCTGTT
AGTCATAGGTT -> GTCATAGGTTC
AGTCATTGAAG -> GTCATTGAAGA
AGTCCACGTGA -> GTCCACGTGAA
AGTCCTAGTAA -> GTCCTAGTAAA
AGTCCTATCGA -> GTCCTATCGAG
AGTCGAAGCGA -> GTCGAAGCGAT
AGTCGACACAG -> GTCGACACAGG
AGTCTGGGTCC -> GTCTGGGTCCT
AGTCTGTTGAT -> GTCTGTTGATA
AGTCTTCAATG -> GTCTTCAATGC
AGTCTTGGAAC -> GTCTTGGAACG
AGTGACAGGTA -> GTGACAGGTAC
AGTGACGGCTT -> GTGACGGCTTG
AGTGCTCCCCT -> GTGCTCCCCTG
AGTGCTTGGCT -> GTGCTTGGCTA
AGTGGACAGAG -> GTGGACAGAGA
AGTGGGACGCC -> GTGGGACGCCA
AGTGGTCGTCG -> GTGGTCGTCGC
AGTGTAGACCC -> GTGTAGACCCG
AGTTAATAGCC -> GTTAATAGCCC
AGTTAGTCATT -> GTTAGTCATTG
AGTTCATGCCA -> GTTCATGCCAC
AGTTGACTGCT -> GTTGACTGCTC
AGTTTCACGAG -> GTTTCACGAGA
AGTTTTACATC -> GTTTTACATCG
ATAACAGATCT -> TAACAGATCTT
ATAACAGGACT -> TAACAGGACTT
ATAACAGTCGA -> TAACAGTCGAA
ATAACCTATTT -> TAACCTATTTA
ATAAGGACAAG -> TAAGGACAAGA
ATAATCTCGCT -> TAATCTCGCTT
ATAATGACCTA -> TAATGACCTAG
ATAATTATAGC -> TAATTATAGCT
ATACAAACACA -> TACAAACACAA
ATACATCGCTC -> TACATCGCTCT
ATACCCTATAT -> TACCCTATATA
ATACGTCTCGT -> TACGTCTCGTT
ATACTGGTGTC -> TACTGGTGTCC
ATAGATCCTGA -> TAGATCCTGAA
ATAGCACGCCA -> TAGCACGCCAG
ATAGCCCAATC -> TAGCCCAATCT
ATAGCCCACCA -> TAGCCCACCAT
ATAGCCCCTTG -> TAGCCCCTTGT
ATAGCTATACA -> TAGCTATACAT
ATAGCTCTTCT -> TAGCTCTTCTG
ATAGCTTGCTC -> TAGCTTGCTCA
ATAGGCATTTA -> TAGGCATTTAC
ATAGGGCGGCG -> TAGGGCGGCGG
ATAGGGCTGAG -> TAGGGCTGAGG
ATAGGGCTTCG -> TAGGGCTTCGG
ATAGGTTCTGG -> TAGGTTCTGGG
ATAGTCAGCTC -> TAGTCAGCTCG
ATAGTCATAGG -> TAGTCATAGGT
ATATAGGCATT -> TATAGGCATTT
ATATAGTCATA -> TATAGTCATAG
ATATCACTAGA -> TATCACTAGAG
ATATCCCCGCT -> TATCCCCGCTA
ATATCGCATAG -> TATCGCATAGC
ATATGAATGTT -> TATGAATGTTG
ATATGGCTAGT -> TATGGCTAGTG
ATATTAACCCG -> TATTAACCCGA
ATATTCACCGG -> TATTCACCGGC
ATATTGTATCG -> TATTGTATCGT
ATCAAAGCGAA -> TCAAAGCGAAA
ATCAACTCCTT -> TCAACTCCTTT
ATCAAGAGTGA -> TCAAGAGTGAC
ATCAATTCAAA -> TCAATTCAAAG
ATCACGAGCTA -> TCACGAGCTAA
ATCACTAGAGT -> TCACTAGAGTC
ATCATTTCATA -> TCATTTCATAA
ATCCACCTCGT -> TCCACCTCGTA
ATCCACGCCCT -> TCCACGCCCTA
ATCCCCGCTAA -> TCCCCGCTAAT
ATCCCGTAGAT -> TCCCGTAGATC
ATCCGACAGCC -> TCCGACAGCCC
ATCCTGAACTG -> TCCTGAACTGC
ATCGAATACTG -> TCGAATACTGG
ATCGAGGAGGC -> TCGAGGAGGCG
ATCGCATAGCC -> TCGCATAGCCC
ATCGCCCAACT -> TCGCCCAACTA
ATCGCCCATTA -> TCGCCCATTAA
ATCGCGCCGTC -> TCGCGCCGTCA
ATCGCTCTGGA -> TCGCTCTGGAC
ATCGGCGTTTG -> TCGGCGTTTGC
ATCGGGTCTAG -> TCGGGTCTAGG
ATCGTATGTAC -> TCGTATGTACG
ATCGTTTCTCA -> TCGTTTCTCAA
ATCTACCAGCG -> TCTACCAGCGC
ATCTACCTAGT -> TCTACCTAGTC
ATCTATTCGGC -> TCTATTCGGCT
ATCTCAGTGAC -> TCTCAGTGACA
ATCTCGCAACT -> TCTCGCAACTC
ATCTCGCTTCA -> TCTCGCTTCAC
ATCTCGCTTTG -> TCTCGCTTTGC
ATCTCTGTCTT -> TCTCTGTCTTA
ATCTGCTGGAC -> TCTGCTGGACC
ATCTTATAGCC -> TCTTATAGCCC
ATCTTATCCCG -> TCTTATCCCGT
ATCTTATTATA -> TCTTATTATAT
ATCTTGCGGTT -> TCTTGCGGTTT
ATGAACGAAAC -> TGAACGAAACG
ATGAAGAGCGA -> TGAAGAGCGAT
ATGAATGTTGC -> TGAATGTTGCC
ATGACCTAGTC -> TGACCTAGTCA
ATGAGGAACCC -> TGAGGAACCCG
ATGAGGCTACG -> TGAGGCTACGA
ATGAGTACTTG -> TGAGTACTTGC
ATGATGGTGCG -> TGATGGTGCGC
ATGCATCGGGT -> TGCATCGGGTC
ATGCCACCCGC -> TGCCACCCGCC
ATGCGGGCTCA -> TGCGGGCTCAG
ATGCTACCGAA -> TGCTACCGAAA
ATGCTGAGAAT -> TGCTGAGAATA
ATGCTTTAGCC -> TGCTTTAGCCC
ATGGCATCACG -> TGGCATCACGA
ATGGCTAGTGG -> TGGCTAGTGGG
ATGGGACGACC -> TGGGACGACCC
ATGGGTCACGA -> TGGGTCACGAT
ATGGTAGCTAT -> TGGTAGCTATC
ATGGTGAATAA -> TGGTGAATAAC
ATGGTGCGCGA -> TGGTGCGCGAA
ATGGTGTTGGA -> TGGTGTTGGAG
ATGTAATGAAG -> TGTAATGAAGA
ATGTACATCGC -> TGTACATCGCC
ATGTACGATCA -> TGTACGATCAA
ATGTATCGTAT -> TGTATCGTATG
ATGTCAGTGCT -> TGTCAGTGCTT
ATGTGCGTCTT -> TGTGCGTCTTG
ATGTGTGGCTA -> TGTGTGGCTAC
ATGTTGCCCGG -> TGTTGCCCGGT
ATGTTTGCTAT -> TGTTTGCTATT
ATTAAACCGGT -> TTAAACCGGTT
ATTAAAGGAAG -> TTAAAGGAAGG
ATTAACCCGAC -> TTAACCCGACT
ATTAACTTTTA -> TTAACTTTTAG
ATTAATGGTGT -> TTAATGGTGTT
ATTACTTACTT -> TTACTTACTTC
ATTAGGTTTCT -> TTAGGTTTCTG
ATTATAGCTAT -> TTATAGCTATA
ATTATATCACT -> TTATATCACTA
ATTATGTGTGG -> TTATGTGTGGC
ATTCAAAGACG -> TTCAAAGACGA
ATTCACCGGCT -> TTCACCGGCTG
ATTCGGCTTTA -> TTCGGCTTTAT
ATTCTATCTCA -> TTCTATCTCAG
ATTGAAGAGAA -> TTGAAGAGAAT
ATTGAGTCCTA -> TTGAGTCCTAG
ATTGTATCGTT -> TTGTATCGTTT
ATTGTGATATG -> TTGTGATATGG
ATTTACCGATA -> TTTACCGATAA
ATTTAGATGTC -> TTTAGATGTCA
ATTTATGTACA -> TTTATGTACAT
ATTTCATAATC -> TTTCATAATCT
ATTTCCTCTCA -> TTTCCTCTCAG
ATTTGGCTCGA -> TTTGGCTCGAG
ATTTGGTACGA -> TTTGGTACGAC
CAAAAAACCGA -> AAAAAACCGAT
CAAACACAAAG -> AAACACAAAGA
CAAACACTATC -> AAACACTATCA
CAAAGACATCG -> AAAGACATCGC
CAAAGACGACT -> AAAGACGACTC
CAAAGATCTTA -> AAAGATCTTAT
CAAAGCGAAAT -> AAAGCGAAATG
CAAAGGAATCT -> AAAGGAATCTG
CAACAGTTTTA -> AACAGTTTTAC
CAACATGGTGA -> AACATGGTGAA
CAACTACCTCG -> AACTACCTCGG
CAACTCCTTTA -> AACTCCTTTAC
CAACTCTCAGG -> AACTCTCAGGC
CAACTGACATC -> AACTGACATCT
CAAGAGTGACG -> AAGAGTGACGG
CAAGAGTGTAG -> AAGAGTGTAGA
CAAGATTAGGT -> AAGATTAGGTT
CAAGCATAGTC -> AAGCATAGTCC
CAAGCCGATTC -> AAGCCGATTCT
CAAGCCGGATG -> AAGCCGGATGG
CAAGGTACGTA -> AAGGTACGTAG
CAAGTAGCACA -> AAGTAGCACAT
CAAGTTAATAG -> AAGTTAATAGC
CAAGTTCATGC -> AAGTTCATGCC
CAATAACAGGA -> AATAACAGGAC
CAATATTAACC -> AATATTAACCC
CAATCAAGAGT -> AATCAAGAGTG
CAATCTACCTA -> AATCTACCTAG
CAATGCTTTAG -> AATGCTTTAGC
CAATTCAAAGA -> AATTCAAAGAC
CACAAAGATCT -> ACAAAGATCTT
CACAAGTTAAT -> ACAAGTTAATA
CACAATATTAA -> ACAATATTAAC
CACACGCGGAC -> ACACGCGGACG
CACACGGAGGA -> ACACGGAGGAC
CACAGGCAGTC -> ACAGGCAGTCA
CACAGGCCTTG -> ACAGGCCTTGA
CACATAGCTTG -> ACATAGCTTGC
CACCATGCATC -> ACCATGCATCG
CACCCGATGGG -> ACCCGATGGGA
CACCCGCCTTT -> ACCCGCCTTTG
CACCCGGACAG -> ACCCGGACAGC
CACCCGTGGCG -> ACCCGTGGCGC
CACCGGCTGTC -> ACCGGCTGTCA
CACCGGTTACA -> ACCGGTTACAC
CACCTCGTAGT -> ACCTCGTAGTC
CACCTTAATGT -> ACCTTAATGTG
CACGAAGCATA -> ACGAAGCATAT
CACGAGATGTA -> ACGAGATGTAA
CACGAGCTAAT -> ACGAGCTAATA
CACGATACCCT -> ACGATACCCTA
CACGCCAGGTA -> ACGCCAGGTAG
CACGCCCTAGC -> ACGCCCTAGCG
CACGCGGACGC -> ACGCGGACGCC
CACGCGTATAA -> ACGCGTATAAT
CACGGAGGACA -> ACGGAGGACAA
CACGGGAGGAT -> ACGGGAGGATA
CACGTGAACCA -> ACGTGAACCAG
CACTAGAGTCC -> ACTAGAGTCCT
CACTATAACAG -> ACTATAACAGT
CACTATCAATT -> ACTATCAATTC
CACTGCATCGG -> ACTGCATCGGC
CAGACGGGCCA -> AGACGGGCCAT
CAGAGACAACA -> AGAGACAACAT
CAGAGCTGTTT -> AGAGCTGTTTG
CAGATCCACCT -> AGATCCACCTC
CAGATCTTATT -> AGATCTTATTA
CAGATGCGGGC -> AGATGCGGGCT
CAGCAGGATCA -> AGCAGGATCAA
CAGCCACCTTA -> AGCCACCTTAA
CAGCCCCTTCA -> AGCCCCTTCAA
CAGCCGGGCCG -> AGCCGGGCCGC
CAGCGCAGATC -> AGCGCAGATCC
CAGCTCGTGAC -> AGCTCGTGACA
CAGGACTTGTA -> AGGACTTGTAC
CAGGAGGTCTT -> AGGAGGTCTTC
CAGGATCAAAG -> AGGATCAAAGC
CAGGCAGTCAG -> AGGCAGTCAGT
CAGGCCTGTAC -> AGGCCTGTACC
CAGGCCTTGAC -> AGGCCTTGACG
CAGGCTCAGCA -> AGGCTCAGCAG
CAGGTAACCTA -> AGGTAACCTAA
CAGGTACATGA -> AGGTACATGAG
CAGGTAGCTAA -> AGGTAGCTAAC
CAGGTCTTACA -> AGGTCTTACAC
CAGTAGAAGAG -> AGTAGAAGAGG
CAGTCAGTCTG -> AGTCAGTCTGT
CAGTCGAAGCG -> AGTCGAAGCGA
CAGTCTGTTGA -> AGTCTGTTGAT
CAGTGACAGGT -> AGTGACAGGTA
CAGTGCTCCCC -> AGTGCTCCCCT
CAGTGCTTGGC -> AGTGCTTGGCT
CAGTTGACTGC -> AGTTGACTGCT
CAGTTTCACGA -> AGTTTCACGAG
CAGTTTTACAT -> AGTTTTACATC
CATAAGGACAA -> ATAAGGACAAG
CATAATCTCGC -> ATAATCTCGCT
CATAGCCCCTT -> ATAGCCCCTTG
CATAGCTTGCT -> ATAGCTTGCTC
CATAGGGCTGA -> ATAGGGCTGAG
CATAGGTTCTG -> ATAGGTTCTGG
CATAGTCAGCT -> ATAGTCAGCTC
CATATCCCCGC -> ATATCCCCGCT
CATCACGAGCT -> ATCACGAGCTA
CATCATTTCAT -> ATCATTTCATA
CATCCACGCCC -> ATCCACGCCCT
CATCGCCCAAC -> ATCGCCCAACT
CATCGCCCATT -> ATCGCCCATTA
CATCGCGCCGT -> ATCGCGCCGTC
CATCGCTCTGG -> ATCGCTCTGGA
CATCGGCGTTT -> ATCGGCGTTTG
CATCGGGTCTA -> ATCGGGTCTAG
CATCTATTCGG -> ATCTATTCGGC
CATCTCGCAAC -> ATCTCGCAACT
CATCTCGCTTC -> ATCTCGCTTCA
CATCTTGCGGT -> ATCTTGCGGTT
CATGAGGAACC -> ATGAGGAACCC
CATGAGTACTT -> ATGAGTACTTG
CATGCATCGGG -> ATGCATCGGGT
CATGCCACCCG -> ATGCCACCCGC
CATGCTGAGAA -> ATGCTGAGAAT
CATGGTAGCTA -> ATGGTAGCTAT
CATGGTGAATA -> ATGGTGAATAA
CATGTATCGTA -> ATGTATCGTAT
CATTAACTTTT -> ATTAACTTTTA
CATTAATGGTG -> ATTAATGGTGT
CATTGAAGAGA -> ATTGAAGAGAA
CATTGAGTCCT -> ATTGAGTCCTA
CATTGTGATAT -> ATTGTGATATG
CATTTACCGAT -> ATTTACCGATA
CATTTCATAAT -> ATTTCATAATC
CATTTCCTCTC -> ATTTCCTCTCA
CCAAACACTAT -> CAAACACTATC
CCAAAGGAATC -> CAAAGGAATCT
CCAACTACCTC -> CAACTACCTCG
CCAAGCCGGAT -> CAAGCCGGATG
CCAAGTAGCAC -> CAAGTAGCACA
CCAATCAAGAG -> CAATCAAGAGT
CCAATCTACCT -> CAATCTACCTA
CCACAAGTTAA -> CACAAGTTAAT
CCACAGGCCTT -> CACAGGCCTTG
CCACCATGCAT -> CACCATGCATC
CCACCCGATGG -> CACCCGATGGG
CCACCCGCCTT -> CACCCGCCTTT
CCACCTCGTAG -> CACCTCGTAGT
CCACCTTAATG -> CACCTTAATGT
CCACGAAGCAT -> CACGAAGCATA
CCACGCCCTAG -> CACGCCCTAGC
CCACGTGAACC -> CACGTGAACCA
CCAGATGCGGG -> CAGATGCGGGC
CCAGCGCAGAT -> CAGCGCAGATC
CCAGGTAACCT -> CAGGTAACCTA
CCAGGTAGCTA -> CAGGTAGCTAA
CCAGGTCTTAC -> CAGGTCTTACA
CCAGTGCTCCC -> CAGTGCTCCCC
CCATAGGGCTG -> CATAGGGCTGA
CCATAGTCAGC -> CATAGTCAGCT
CCATGCATCGG -> CATGCATCGGG
CCATGCTGAGA -> CATGCTGAGAA
CCATGGTAGCT -> CATGGTAGCTA
CCATTAACTTT -> CATTAACTTTT
CCATTAATGGT -> CATTAATGGTG
CCATTGTGATA -> CATTGTGATAT
CCATTTCCTCT -> CATTTCCTCTC
CCCAACTACCT -> CCAACTACCTC
CCCAATCTACC -> CCAATCTACCT
CCCACCATGCA -> CCACCATGCAT
CCCATGCTGAG -> CCATGCTGAGA
CCCATTAACTT -> CCATTAACTTT
CCCATTTCCTC -> CCATTTCCTCT
CCCCGAAGTTA -> CCCGAAGTTAG
CCCCGCTAATC -> CCCGCTAATCT
CCCCTGCTTTC -> CCCTGCTTTCA
CCCCTTCAAGT -> CCCTTCAAGTT
CCCCTTGTGCG -> CCCTTGTGCGG
CCCGAAGTTAG -> CCGAAGTTAGT
CCCGACTGGGA -> CCGACTGGGAT
CCCGAGTCCAC -> CCGAGTCCACG
CCCGATGGGAC -> CCGATGGGACG
CCCGCCTTTGA -> CCGCCTTTGAT
CCCGCTAATCT -> CCGCTAATCTC
CCCGGACAGCC -> CCGGACAGCCG
CCCGGCGCGAG -> CCGGCGCGAGT
CCCGGTAGCAT -> CCGGTAGCATC
CCCGGTCAAGC -> CCGGTCAAGCC
CCCGTAGATCC -> CCGTAGATCCG
CCCGTGGCGCG -> CCGTGGCGCGT
CCCTAGACAGT -> CCTAGACAGTT
CCCTAGCGTGG -> CCTAGCGTGGA
CCCTATATAGT -> CCTATATAGTC
CCCTGCTTTCA -> CCTGCTTTCAT
CCCTGTGGAGA -> CCTGTGGAGAC
CCCTTCAAGTT -> CCTTCAAGTTC
CCCTTGATTAC -> CCTTGATTACT
CCCTTGTGCGG -> CCTTGTGCGGG
CCCTTTAGCAG -> CCTTTAGCAGG
CCGAAATTATG -> CGAAATTATGT
CCGAAGTTAGT -> CGAAGTTAGTC
CCGACAGCCCC -> CGACAGCCCCT
CCGACTGGGAT -> CGACTGGGATA
CCGAGTCCACG -> CGAGTCCACGT
CCGATAATTAT -> CGATAATTATA
CCGATGAGGCT -> CGATGAGGCTA
CCGATGGGACG -> CGATGGGACGA
CCGATTCTATC -> CGATTCTATCT
CCGATTTGGCT -> CGATTTGGCTC
CCGCCTTTGAT -> CGCCTTTGATA
CCGCGATATCG -> CGCGATATCGC
CCGCGCCAAGT -> CGCGCCAAGTA
CCGCTAATCTC -> CGCTAATCTCT
CCGGACAGCCG -> CGGACAGCCGG
CCGGATGGGTC -> CGGATGGGTCA
CCGGCGCGAGT -> CGGCGCGAGTG
CCGGCTGTCAT -> CGGCTGTCATA
CCGGGCCGCGC -> CGGGCCGCGCC
CCGGGGTCCAT -> CGGGGTCCATT
CCGGTAGCATC -> CGGTAGCATCT
CCGGTCAAGCC -> CGGTCAAGCCG
CCGGTTACACC -> CGGTTACACCC
CCGGTTCGGTC -> CGGTTCGGTCC
CCGTAGATCCG -> CGTAGATCCGA
CCGTCACCCGG -> CGTCACCCGGA
CCGTGGCGCGT -> CGTGGCGCGTC
CCTAACATCCA -> CTAACATCCAC
CCTACACACGG -> CTACACACGGA
CCTACGGGCTA -> CTACGGGCTAG
CCTAGACAGTT -> CTAGACAGTTG
CCTAGCGTGGA -> CTAGCGTGGAT
CCTAGTAAAAG -> CTAGTAAAAGC
CCTAGTCACAA -> CTAGTCACAAT
CCTAGTCTTGG -> CTAGTCTTGGA
CCTATATAGTC -> CTATATAGTCA
CCTATCGAGGA -> CTATCGAGGAG
CCTATTTATGT -> CTATTTATGTA
CCTCCAAAGGA -> CTCCAAAGGAA
CCTCGGAACAA -> CTCGGAACAAA
CCTCGTAGTCT -> CTCGTAGTCTG
CCTCTCAGTAG -> CTCTCAGTAGA
CCTGAACTGCC -> CTGAACTGCCG
CCTGCTTAACA -> CTGCTTAACAA
CCTGCTTTCAT -> CTGCTTTCATC
CCTGTACCTAC -> CTGTACCTACG
CCTGTGGAGAC -> CTGTGGAGACC
CCTGTGTCCAT -> CTGTGTCCATA
CCTTAATGTGC -> CTTAATGTGCG
CCTTCAAGTTC -> CTTCAAGTTCA
CCTTGACGTCC -> CTTGACGTCCC
CCTTGATTACT -> CTTGATTACTT
CCTTGTGCGGG -> CTTGTGCGGGA
CCTTTACTCCG -> CTTTACTCCGG
CCTTTAGCAGG -> CTTTAGCAGGA
CCTTTGATAAC -> CTTTGATAACA
CGAAACGCCAC -> GAAACGCCACG
CGAAATGGCAT -> GAAATGGCATC
CGAAATTATGT -> GAAATTATGTG
CGAACTAGTCG -> GAACTAGTCGA
CGAACTCTAGG -> GAACTCTAGGA
CGAAGACCATT -> GAAGACCATTA
CGAAGCATATC -> GAAGCATATCC
CGAAGCGATTA -> GAAGCGATTAA
CGAAGTTAGTC -> GAAGTTAGTCA
CGAATACTGGT -> GAATACTGGTG
CGACACAGGCA -> GACACAGGCAG
CGACAGCCCCT -> GACAGCCCCTT
CGACCCTTGAT -> GACCCTTGATT
CGACTCAAGGT -> GACTCAAGGTA
CGACTGGGATA -> GACTGGGATAC
CGACTTCGTAA -> GACTTCGTAAC
CGAGACTTCCA -> GAGACTTCCAG
CGAGAGCCACA -> GAGAGCCACAA
CGAGATGTAAT -> GAGATGTAATG
CGAGCTAATAG -> GAGCTAATAGC
CGAGGAGGCGG -> GAGGAGGCGGG
CGAGTCCACGT -> GAGTCCACGTG
CGAGTGGACAG -> GAGTGGACAGA
CGATAATTATA -> GATAATTATAG
CGATACCCTAT -> GATACCCTATA
CGATATCGCAT -> GATATCGCATA
CGATATGAATG -> GATATGAATGT
CGATCAACTCC -> GATCAACTCCT
CGATGAGGCTA -> GATGAGGCTAC
CGATGGGACGA -> GATGGGACGAC
CGATTAAACCG -> GATTAAACCGG
CGATTCTATCT -> GATTCTATCTC
CGATTTGGCTC -> GATTTGGCTCG
CGCAACTCTCA -> GCAACTCTCAG
CGCAGATCCAC -> GCAGATCCACC
CGCATAGCCCC -> GCATAGCCCCT
CGCATGTATCG -> GCATGTATCGT
CGCCAAGTAGC -> GCCAAGTAGCA
CGCCACAGGCC -> GCCACAGGCCT
CGCCACGAAGC -> GCCACGAAGCA
CGCCAGGTAGC -> GCCAGGTAGCT
CGCCAGGTCTT -> GCCAGGTCTTA
CGCCAGTGCTC -> GCCAGTGCTCC
CGCCCAACTAC -> GCCCAACTACC
CGCCCATGCTG -> GCCCATGCTGA
CGCCCATTAAC -> GCCCATTAACT
CGCCCTAGCGT -> GCCCTAGCGTG
CGCCCTGTGGA -> GCCCTGTGGAG
CGCCGTCACCC -> GCCGTCACCCG
CGCCTGTGTCC -> GCCTGTGTCCA
CGCCTTTGATA -> GCCTTTGATAA
CGCGAACTAGT -> GCGAACTAGTC
CGCGAGACTTC -> GCGAGACTTCC
CGCGAGTGGAC -> GCGAGTGGACA
CGCGATATCGC -> GCGATATCGCA
CGCGCCAAGTA -> GCGCCAAGTAG
CGCGCCGTCAC -> GCGCCGTCACC
CGCGGAATCTA -> GCGGAATCTAC
CGCGGACGCCC -> GCGGACGCCCT
CGCGTATAATG -> GCGTATAATGA
CGCGTCTCGGT -> GCGTCTCGGTA
CGCTAATCTCT -> GCTAATCTCTG
CGCTCTGGACT -> GCTCTGGACTG
CGCTTCACTGC -> GCTTCACTGCA
CGCTTTGCACC -> GCTTTGCACCG
CGGAAACTCTT -> GGAAACTCTTC
CGGAACAAAAA -> GGAACAAAAAA
CGGAACCATAG -> GGAACCATAGG
CGGAATCTACC -> GGAATCTACCA
CGGACAGCCGG -> GGACAGCCGGG
CGGACGCCCTG -> GGACGCCCTGT
CGGAGGACAAG -> GGAGGACAAGA
CGGATGGGTCA -> GGATGGGTCAC
CGGCAGGCTCA -> GGCAGGCTCAG
CGGCGCGAGTG -> GGCGCGAGTGG
CGGCGGAACCA -> GGCGGAACCAT
CGGCGTTTGCA -> GGCGTTTGCAT
CGGCTCAAGCA -> GGCTCAAGCAT
CGGCTGTCATA -> GGCTGTCATAA
CGGCTTGCAGA -> GGCTTGCAGAG
CGGCTTTATTA -> GGCTTTATTAA
CGGGAAGTAAG -> GGGAAGTAAGG
CGGGAGGATAG -> GGGAGGATAGG
CGGGATTTGGT -> GGGATTTGGTA
CGGGCCATGGT -> GGGCCATGGTA
CGGGCCGCGCC -> GGGCCGCGCCA
CGGGCTAGCTA -> GGGCTAGCTAC
CGGGCTCAGAC -> GGGCTCAGACG
CGGGGTCCATT -> GGGGTCCATTG
CGGGTCTAGGG -> GGGTCTAGGGT
CGGTAGCATCT -> GGTAGCATCTT
CGGTAGCATGA -> GGTAGCATGAG
CGGTCAAGCCG -> GGTCAAGCCGA
CGGTCCTGCTT -> GGTCCTGCTTA
CGGTTACACCC -> GGTTACACCCG
CGGTTACCAAT -> GGTTACCAATC
CGGTTCGGTCC -> GGTTCGGTCCT
CGGTTTTGAAT -> GGTTTTGAATA
CGTAACCCATT -> GTAACCCATTT
CGTAGACGCCA -> GTAGACGCCAC
CGTAGATCCGA -> GTAGATCCGAC
CGTAGTCTGGG -> GTAGTCTGGGT
CGTATAATGAC -> GTATAATGACC
CGTATGTACGA -> GTATGTACGAT
CGTCACCCGGA -> GTCACCCGGAC
CGTCCCGGTCA -> GTCCCGGTCAA
CGTCGCCAGGT -> GTCGCCAGGTC
CGTCTATGCTA -> GTCTATGCTAC
CGTCTCGGTAG -> GTCTCGGTAGC
CGTCTCGTTTA -> GTCTCGTTTAA
CGTCTTGTAAG -> GTCTTGTAAGA
CGTGAACCAGG -> GTGAACCAGGT
CGTGACAATAA -> GTGACAATAAC
CGTGGATGAAC -> GTGGATGAACG
CGTGGCGCGTC -> GTGGCGCGTCT
CGTTTAAAAGT -> GTTTAAAAGTG
CGTTTCTCAAC -> GTTTCTCAACT
CGTTTGCATCA -> GTTTGCATCAT
CTAACATCCAC -> TAACATCCACG
CTAACGCCCAT -> TAACGCCCATG
CTAATAGCTCT -> TAATAGCTCTT
CTAATCTCTGT -> TAATCTCTGTC
CTACACACGGA -> TACACACGGAG
CTACATCTCGC -> TACATCTCGCT
CTACCAGCGCA -> TACCAGCGCAG
CTACCGAAATT -> TACCGAAATTA
CTACCTAGTCT -> TACCTAGTCTT
CTACCTCGGAA -> TACCTCGGAAC
CTACGAAGACC -> TACGAAGACCA
CTACGGGCTAG -> TACGGGCTAGC
CTACTCACGGG -> TACTCACGGGA
CTAGACAGTTG -> TAGACAGTTGA
CTAGAGTCCTA -> TAGAGTCCTAT
CTAGCGTGGAT -> TAGCGTGGATG
CTAGCTACTCA -> TAGCTACTCAC
CTAGGAGTCTT -> TAGGAGTCTTC
CTAGGGTTAAT -> TAGGGTTAATG
CTAGTAAAAGC -> TAGTAAAAGCA
CTAGTCACAAT -> TAGTCACAATA
CTAGTCGACAC -> TAGTCGACACA
CTAGTCTTGGA -> TAGTCTTGGAA
CTAGTGGGACG -> TAGTGGGACGC
CTATAACAGTC -> TATAACAGTCG
CTATACAAACA -> TATACAAACAC
CTATACATCGC -> TATACATCGCT
CTATATAGTCA -> TATATAGTCAT
CTATCAATTCA -> TATCAATTCAA
CTATCGAATAC -> TATCGAATACT
CTATCGAGGAG -> TATCGAGGAGG
CTATCTCAGTG -> TATCTCAGTGA
CTATGCTACCG -> TATGCTACCGA
CTATTCGGCTT -> TATTCGGCTTT
CTATTTAGATG -> TATTTAGATGT
CTATTTATGTA -> TATTTATGTAC
CTCAACTGACA -> TCAACTGACAT
CTCAAGCATAG -> TCAAGCATAGT
CTCAAGGTACG -> TCAAGGTACGT
CTCACACGCGG -> TCACACGCGGA
CTCACGGGAGG -> TCACGGGAGGA
CTCAGACGGGC -> TCAGACGGGCC
CTCAGCAGGAT -> TCAGCAGGATC
CTCAGGCCTGT -> TCAGGCCTGTA
CTCAGTAGAAG -> TCAGTAGAAGA
CTCAGTGACAG -> TCAGTGACAGG
CTCAGTTTCAC -> TCAGTTTCACG
CTCCAAAGGAA -> TCCAAAGGAAT
CTCCCCTGCTT -> TCCCCTGCTTT
CTCCGGGGTCC -> TCCGGGGTCCA
CTCCTTTACTC -> TCCTTTACTCC
CTCGAGAGCCA -> TCGAGAGCCAC
CTCGCAACTCT -> TCGCAACTCTC
CTCGCTTCACT -> TCGCTTCACTG
CTCGCTTTGCA -> TCGCTTTGCAC
CTCGGAACAAA -> TCGGAACAAAA
CTCGGTAGCAT -> TCGGTAGCATG
CTCGTAGTCTG -> TCGTAGTCTGG
CTCGTCTATGC -> TCGTCTATGCT
CTCGTGACAAT -> TCGTGACAATA
CTCGTTTAAAA -> TCGTTTAAAAG
CTCTAGGAGTC -> TCTAGGAGTCT
CTCTCAGGCCT -> TCTCAGGCCTG
CTCTCAGTAGA -> TCTCAGTAGAA
CTCTGGACTGG -> TCTGGACTGGT
CTCTGTCTTAC -> TCTGTCTTACA
CTCTTCCCTTT -> TCTTCCCTTTA
CTCTTCTGCGC -> TCTTCTGCGCC
CTGAAATAGGG -> TGAAATAGGGC
CTGAACTGCCG -> TGAACTGCCGA
CTGACATCTAT -> TGACATCTATT
CTGAGAATATT -> TGAGAATATTG
CTGAGGGGCTT -> TGAGGGGCTTA
CTGCATCGGCG -> TGCATCGGCGT
CTGCCGATGAG -> TGCCGATGAGG
CTGCGCCTGTG -> TGCGCCTGTGT
CTGCTCGTCTA -> TGCTCGTCTAT
CTGCTGGACCA -> TGCTGGACCAA
CTGCTTAACAA -> TGCTTAACAAA
CTGCTTTCATC -> TGCTTTCATCT
CTGGACCAAAC -> TGGACCAAACA
CTGGACTGGTA -> TGGACTGGTAA
CTGGGATACGT -> TGGGATACGTC
CTGGGGCCCTA -> TGGGGCCCTAG
CTGGGTCCTCC -> TGGGTCCTCCA
CTGGTAACTTC -> TGGTAACTTCG
CTGGTGTCCGC -> TGGTGTCCGCG
CTGTACCTACG -> TGTACCTACGG
CTGTCATAAGG -> TGTCATAAGGA
CTGTCTTACAG -> TGTCTTACAGC
CTGTGGAGACC -> TGTGGAGACCA
CTGTGTCCATA -> TGTGTCCATAG
CTGTTGATAGC -> TGTTGATAGCA
CTGTTTGAAAG -> TGTTTGAAAGG
CTTAACAAAGA -> TTAACAAAGAC
CTTAATGTGCG -> TTAATGTGCGT
CTTACACTATA -> TTACACTATAA
CTTACAGCCAC -> TTACAGCCACC
CTTACTTCACG -> TTACTTCACGC
CTTATAGCCCA -> TTATAGCCCAC
CTTATATAGGC -> TTATATAGGCA
CTTATCCCGTA -> TTATCCCGTAG
CTTATTATATC -> TTATTATATCA
CTTCAAGTTCA -> TTCAAGTTCAT
CTTCAATGCTT -> TTCAATGCTTT
CTTCACGCGTA -> TTCACGCGTAT
CTTCACTGCAT -> TTCACTGCATC
CTTCCAGATGC -> TTCCAGATGCG
CTTCCCTTTAG -> TTCCCTTTAGC
CTTCGCGGAAT -> TTCGCGGAATC
CTTCGGAAACT -> TTCGGAAACTC
CTTCGGCTCAA -> TTCGGCTCAAG
CTTCGTAACCC -> TTCGTAACCCA
CTTCTGCGCCT -> TTCTGCGCCTG
CTTGACGTCCC -> TTGACGTCCCG
CTTGATTACTT -> TTGATTACTTA
CTTGCAGAGCT -> TTGCAGAGCTG
CTTGCGGTTTT -> TTGCGGTTTTG
CTTGCTCACAC -> TTGCTCACACG
CTTGCTCAGTT -> TTGCTCAGTTT
CTTGGAACGGT -> TTGGAACGGTT
CTTGGCTATAC -> TTGGCTATACA
CTTGTAAGATG -> TTGTAAGATGT
CTTGTACGAAC -> TTGTACGAACT
CTTGTGCGGGA -> TTGTGCGGGAA
CTTTACTCCGG -> TTTACTCCGGG
CTTTAGCAGGA -> TTTAGCAGGAG
CTTTAGCCCCG -> TTTAGCCCCGA
CTTTATTAAAG -> TTTATTAAAGG
CTTTCATCTCG -> TTTCATCTCGC
CTTTGATAACA -> TTTGATAACAG
CTTTGCACCGG -> TTTGCACCGGT
CTTTTAGACCT -> TTTTAGACCTA
GAAACGCCACG -> AAACGCCACGA
GAAACTCTTCC -> AAACTCTTCCC
GAAAGGTAGCG -> AAAGGTAGCGG
GAAATAGGGCT -> AAATAGGGCTT
GAAATGGCATC -> AAATGGCATCA
GAAATTATGTG -> AAATTATGTGT
GAACAAAAAAC -> AACAAAAAACC
GAACCAGGTAA -> AACCAGGTAAC
GAACCATAGGG -> AACCATAGGGC
GAACCCGGCGC -> AACCCGGCGCG
GAACGAAACGC -> AACGAAACGCC
GAACGGTTACC -> AACGGTTACCA
GAACTAGTCGA -> AACTAGTCGAC
GAACTCTAGGA -> AACTCTAGGAG
GAACTGCCGAT -> AACTGCCGATG
GAAGACCATTA -> AAGACCATTAA
GAAGAGAATCT -> AAGAGAATCTT
GAAGAGCGATA -> AAGAGCGATAT
GAAGAGGTTTG -> AAGAGGTTTGC
GAAGCATATCC -> AAGCATATCCC
GAAGCGATTAA -> AAGCGATTAAA
GAAGGCGCATG -> AAGGCGCATGT
GAAGTAAGGGT -> AAGTAAGGGTT
GAAGTTAGTCA -> AAGTTAGTCAT
GAATAACCTAT -> AATAACCTATT
GAATACTGGTG -> AATACTGGTGT
GAATAGATCCT -> AATAGATCCTG
GAATATTGTAT -> AATATTGTATC
GAATCTACCAG -> AATCTACCAGC
GAATCTGCTGG -> AATCTGCTGGA
GAATCTTATAG -> AATCTTATAGC
GAATGTTGCCC -> AATGTTGCCCG
GACAACATGGT -> ACAACATGGTG
GACAAGAGTGT -> ACAAGAGTGTA
GACAAGATTAG -> ACAAGATTAGG
GACAATAACAG -> ACAATAACAGG
GACACAGGCAG -> ACACAGGCAGT
GACAGAGACAA -> ACAGAGACAAC
GACAGCCCCTT -> ACAGCCCCTTC
GACAGCCGGGC -> ACAGCCGGGCC
GACAGGTACAT -> ACAGGTACATG
GACAGTTGACT -> ACAGTTGACTG
GACATCGCGCC -> ACATCGCGCCG
GACATCTATTC -> ACATCTATTCG
GACCAAACACT -> ACCAAACACTA
GACCAAGCCGG -> ACCAAGCCGGA
GACCACCCGAT -> ACCACCCGATG
GACCATTAATG -> ACCATTAATGG
GACCCGAGTCC -> ACCCGAGTCCA
GACCCTTGATT -> ACCCTTGATTA
GACCTACACAC -> ACCTACACACG
GACCTAGTCAC -> ACCTAGTCACA
GACGACCCTTG -> ACGACCCTTGA
GACGACTCAAG -> ACGACTCAAGG
GACGCCACAGG -> ACGCCACAGGC
GACGCCAGTGC -> ACGCCAGTGCT
GACGCCCTGTG -> ACGCCCTGTGG
GACGGCTTGCA -> ACGGCTTGCAG
GACGGGCCATG -> ACGGGCCATGG
GACGTCCCGGT -> ACGTCCCGGTC
GACTCAAGGTA -> ACTCAAGGTAC
GACTGCTCGTC -> ACTGCTCGTCT
GACTGGGATAC -> ACTGGGATACG
GACTGGTAACT -> ACTGGTAACTT
GACTTCCAGAT -> ACTTCCAGATG
GACTTCGTAAC -> ACTTCGTAACC
GACTTGTACGA -> ACTTGTACGAA
GAGAATATTGT -> AGAATATTGTA
GAGAATCTTAT -> AGAATCTTATA
GAGACAACATG -> AGACAACATGG
GAGACCACCCG -> AGACCACCCGA
GAGACTTCCAG -> AGACTTCCAGA
GAGAGCCACAA -> AGAGCCACAAG
GAGATATTCAC -> AGATATTCACC
GAGATGTAATG -> AGATGTAATGA
GAGCCACAAGT -> AGCCACAAGTT
GAGCGATATGA -> AGCGATATGAA
GAGCTAATAGC -> AGCTAATAGCT
GAGCTGTTTGA -> AGCTGTTTGAA
GAGGAACCCGG -> AGGAACCCGGC
GAGGACAAGAT -> AGGACAAGATT
GAGGAGGCGGG -> AGGAGGCGGGA
GAGGATAGGGC -> AGGATAGGGCG
GAGGCGGGATT -> AGGCGGGATTT
GAGGCTACGAA -> AGGCTACGAAG
GAGGGGCTTAT -> AGGGGCTTATA
GAGGTCTTCGC -> AGGTCTTCGCG
GAGGTTTGCGC -> AGGTTTGCGCG
GAGTACTTGCT -> AGTACTTGCTC
GAGTCCACGTG -> AGTCCACGTGA
GAGTCCTAGTA -> AGTCCTAGTAA
GAGTCCTATCG -> AGTCCTATCGA
GAGTCTTCAAT -> AGTCTTCAATG
GAGTGACGGCT -> AGTGACGGCTT
GAGTGGACAGA -> AGTGGACAGAG
GAGTGTAGACC -> AGTGTAGACCC
GATAACAGATC -> ATAACAGATCT
GATAATTATAG -> ATAATTATAGC
GATACCCTATA -> ATACCCTATAT
GATACGTCTCG -> ATACGTCTCGT
GATAGCACGCC -> ATAGCACGCCA
GATAGGGCGGC -> ATAGGGCGGCG
GATATCGCATA -> ATATCGCATAG
GATATGAATGT -> ATATGAATGTT
GATATGGCTAG -> ATATGGCTAGT
GATATTCACCG -> ATATTCACCGG
GATCAAAGCGA -> ATCAAAGCGAA
GATCAACTCCT -> ATCAACTCCTT
GATCCACCTCG -> ATCCACCTCGT
GATCCGACAGC -> ATCCGACAGCC
GATCCTGAACT -> ATCCTGAACTG
GATCTTATCCC -> ATCTTATCCCG
GATCTTATTAT -> ATCTTATTATA
GATGAACGAAA -> ATGAACGAAAC
GATGAGGCTAC -> ATGAGGCTACG
GATGCGGGCTC -> ATGCGGGCTCA
GATGGGACGAC -> ATGGGACGACC
GATGGGTCACG -> ATGGGTCACGA
GATGGTGCGCG -> ATGGTGCGCGA
GATGTAATGAA -> ATGTAATGAAG
GATGTCAGTGC -> ATGTCAGTGCT
GATGTTTGCTA -> ATGTTTGCTAT
GATTAAACCGG -> ATTAAACCGGT
GATTACTTACT -> ATTACTTACTT
GATTAGGTTTC -> ATTAGGTTTCT
GATTCTATCTC -> ATTCTATCTCA
GATTTGGCTCG -> ATTTGGCTCGA
GATTTGGTACG -> ATTTGGTACGA
GCAACAGTTTT -> CAACAGTTTTA
GCAACTCTCAG -> CAACTCTCAGG
GCACATAGCTT -> CACATAGCTTG
GCACCGGTTAC -> CACCGGTTACA
GCACGCCAGGT -> CACGCCAGGTA
GCAGAGCTGTT -> CAGAGCTGTTT
GCAGATCCACC -> CAGATCCACCT
GCAGGAGGTCT -> CAGGAGGTCTT
GCAGGATCAAA -> CAGGATCAAAG
GCAGGCTCAGC -> CAGGCTCAGCA
GCAGTCAGTCT -> CAGTCAGTCTG
GCATAGCCCCT -> CATAGCCCCTT
GCATAGTCCAC -> CATAGTCCACA
GCATATCCCCG -> CATATCCCCGC
GCATCACGAGC -> CATCACGAGCT
GCATCATTTCA -> CATCATTTCAT
GCATCGGCGTT -> CATCGGCGTTT
GCATCGGGTCT -> CATCGGGTCTA
GCATCTTGCGG -> CATCTTGCGGT
GCATGAGGAAC -> CATGAGGAACC
GCATGTATCGT -> CATGTATCGTA
GCATTTACCGA -> CATTTACCGAT
GCCAAGTAGCA -> CCAAGTAGCAC
GCCACAAGTTA -> CCACAAGTTAA
GCCACAGGCCT -> CCACAGGCCTT
GCCACCCGCCT -> CCACCCGCCTT
GCCACCTTAAT -> CCACCTTAATG
GCCACGAAGCA -> CCACGAAGCAT
GCCAGGTAGCT -> CCAGGTAGCTA
GCCAGGTCTTA -> CCAGGTCTTAC
GCCAGTGCTCC -> CCAGTGCTCCC
GCCATGGTAGC -> CCATGGTAGCT
GCCCAACTACC -> CCCAACTACCT
GCCCAATCTAC -> CCCAATCTACC
GCCCACCATGC -> CCCACCATGCA
GCCCATGCTGA -> CCCATGCTGAG
GCCCATTAACT -> CCCATTAACTT
GCCCCGAAGTT -> CCCCGAAGTTA
GCCCCTTCAAG -> CCCCTTCAAGT
GCCCCTTGTGC -> CCCCTTGTGCG
GCCCGGTAGCA -> CCCGGTAGCAT
GCCCTAGACAG -> CCCTAGACAGT
GCCCTAGCGTG -> CCCTAGCGTGG
GCCCTGTGGAG -> CCCTGTGGAGA
GCCGATGAGGC -> CCGATGAGGCT
GCCGATTCTAT -> CCGATTCTATC
GCCGCGCCAAG -> CCGCGCCAAGT
GCCGGATGGGT -> CCGGATGGGTC
GCCGGGCCGCG -> CCGGGCCGCGC
GCCGTCACCCG -> CCGTCACCCGG
GCCTGTACCTA -> CCTGTACCTAC
GCCTGTGTCCA -> CCTGTGTCCAT
GCCTTGACGTC -> CCTTGACGTCC
GCCTTTGATAA -> CCTTTGATAAC
GCGAAATGGCA -> CGAAATGGCAT
GCGAACTAGTC -> CGAACTAGTCG
GCGAGACTTCC -> CGAGACTTCCA
GCGAGTGGACA -> CGAGTGGACAG
GCGATATCGCA -> CGATATCGCAT
GCGATATGAAT -> CGATATGAATG
GCGATTAAACC -> CGATTAAACCG
GCGCAGATCCA -> CGCAGATCCAC
GCGCATGTATC -> CGCATGTATCG
GCGCCAAGTAG -> CGCCAAGTAGC
GCGCCGTCACC -> CGCCGTCACCC
GCGCCTGTGTC -> CGCCTGTGTCC
GCGCGAACTAG -> CGCGAACTAGT
GCGCGAGACTT -> CGCGAGACTTC
GCGCGAGTGGA -> CGCGAGTGGAC
GCGCGTCTCGG -> CGCGTCTCGGT
GCGGAACCATA -> CGGAACCATAG
GCGGAATCTAC -> CGGAATCTACC
GCGGACGCCCT -> CGGACGCCCTG
GCGGCAGGCTC -> CGGCAGGCTCA
GCGGCGGAACC -> CGGCGGAACCA
GCGGGAAGTAA -> CGGGAAGTAAG
GCGGGATTTGG -> CGGGATTTGGT
GCGGGCTCAGA -> CGGGCTCAGAC
GCGGTTTTGAA -> CGGTTTTGAAT
GCGTATAATGA -> CGTATAATGAC
GCGTCTCGGTA -> CGTCTCGGTAG
GCGTCTTGTAA -> CGTCTTGTAAG
GCGTGGATGAA -> CGTGGATGAAC
GCGTTTGCATC -> CGTTTGCATCA
GCTAACGCCCA -> CTAACGCCCAT
GCTAATAGCTC -> CTAATAGCTCT
GCTAATCTCTG -> CTAATCTCTGT
GCTACATCTCG -> CTACATCTCGC
GCTACCGAAAT -> CTACCGAAATT
GCTACGAAGAC -> CTACGAAGACC
GCTACTCACGG -> CTACTCACGGG
GCTAGCTACTC -> CTAGCTACTCA
GCTAGTGGGAC -> CTAGTGGGACG
GCTATACAAAC -> CTATACAAACA
GCTATACATCG -> CTATACATCGC
GCTATCGAATA -> CTATCGAATAC
GCTATTTAGAT -> CTATTTAGATG
GCTCAAGCATA -> CTCAAGCATAG
GCTCACACGCG -> CTCACACGCGG
GCTCAGACGGG -> CTCAGACGGGC
GCTCAGCAGGA -> CTCAGCAGGAT
GCTCAGTTTCA -> CTCAGTTTCAC
GCTCCCCTGCT -> CTCCCCTGCTT
GCTCGAGAGCC -> CTCGAGAGCCA
GCTCGTCTATG -> CTCGTCTATGC
GCTCGTGACAA -> CTCGTGACAAT
GCTCTGGACTG -> CTCTGGACTGG
GCTCTTCTGCG -> CTCTTCTGCGC
GCTGAGAATAT -> CTGAGAATATT
GCTGAGGGGCT -> CTGAGGGGCTT
GCTGGACCAAA -> CTGGACCAAAC
GCTGTCATAAG -> CTGTCATAAGG
GCTGTTTGAAA -> CTGTTTGAAAG
GCTTAACAAAG -> CTTAACAAAGA
GCTTATATAGG -> CTTATATAGGC
GCTTCACTGCA -> CTTCACTGCAT
GCTTCGGAAAC -> CTTCGGAAACT
GCTTGCAGAGC -> CTTGCAGAGCT
GCTTGCTCAGT -> CTTGCTCAGTT
GCTTGGCTATA -> CTTGGCTATAC
GCTTTAGCCCC -> CTTTAGCCCCG
GCTTTATTAAA -> CTTTATTAAAG
GCTTTCATCTC -> CTTTCATCTCG
GCTTTGCACCG -> CTTTGCACCGG
GGAAACTCTTC -> GAAACTCTTCC
GGAACAAAAAA -> GAACAAAAAAC
GGAACCATAGG -> GAACCATAGGG
GGAACCCGGCG -> GAACCCGGCGC
GGAACGGTTAC -> GAACGGTTACC
GGAAGGCGCAT -> GAAGGCGCATG
GGAAGTAAGGG -> GAAGTAAGGGT
GGAATCTACCA -> GAATCTACCAG
GGAATCTGCTG -> GAATCTGCTGG
GGACAAGAGTG -> GACAAGAGTGT
GGACAAGATTA -> GACAAGATTAG
GGACAGAGACA -> GACAGAGACAA
GGACAGCCGGG -> GACAGCCGGGC
GGACCAAACAC -> GACCAAACACT
GGACGACCCTT -> GACGACCCTTG
GGACGCCAGTG -> GACGCCAGTGC
GGACGCCCTGT -> GACGCCCTGTG
GGACTGGTAAC -> GACTGGTAACT
GGACTTGTACG -> GACTTGTACGA
GGAGACCACCC -> GAGACCACCCG
GGAGATATTCA -> GAGATATTCAC
GGAGGACAAGA -> GAGGACAAGAT
GGAGGATAGGG -> GAGGATAGGGC
GGAGGCGGGAT -> GAGGCGGGATT
GGAGGTCTTCG -> GAGGTCTTCGC
GGAGTCTTCAA -> GAGTCTTCAAT
GGATACGTCTC -> GATACGTCTCG
GGATAGGGCGG -> GATAGGGCGGC
GGATCAAAGCG -> GATCAAAGCGA
GGATGAACGAA -> GATGAACGAAA
GGATGGGTCAC -> GATGGGTCACG
GGATTTGGTAC -> GATTTGGTACG
GGCAGGCTCAG -> GCAGGCTCAGC
GGCAGTCAGTC -> GCAGTCAGTCT
GGCATCACGAG -> GCATCACGAGC
GGCATTTACCG -> GCATTTACCGA
GGCCATGGTAG -> GCCATGGTAGC
GGCCCTAGACA -> GCCCTAGACAG
GGCCGCGCCAA -> GCCGCGCCAAG
GGCCTGTACCT -> GCCTGTACCTA
GGCCTTGACGT -> GCCTTGACGTC
GGCGCATGTAT -> GCGCATGTATC
GGCGCGAGTGG -> GCGCGAGTGGA
GGCGCGTCTCG -> GCGCGTCTCGG
GGCGGAACCAT -> GCGGAACCATA
GGCGGCGGAAC -> GCGGCGGAACC
GGCGGGATTTG -> GCGGGATTTGG
GGCGTTTGCAT -> GCGTTTGCATC
GGCTACATCTC -> GCTACATCTCG
GGCTACGAAGA -> GCTACGAAGAC
GGCTAGCTACT -> GCTAGCTACTC
GGCTAGTGGGA -> GCTAGTGGGAC
GGCTATACAAA -> GCTATACAAAC
GGCTCAAGCAT -> GCTCAAGCATA
GGCTCAGACGG -> GCTCAGACGGG
GGCTCAGCAGG -> GCTCAGCAGGA
GGCTCGAGAGC -> GCTCGAGAGCC
GGCTGAGGGGC -> GCTGAGGGGCT
GGCTGTCATAA -> GCTGTCATAAG
GGCTTATATAG -> GCTTATATAGG
GGCTTCGGAAA -> GCTTCGGAAAC
GGCTTGCAGAG -> GCTTGCAGAGC
GGCTTTATTAA -> GCTTTATTAAA
GGGAAGTAAGG -> GGAAGTAAGGG
GGGACGACCCT -> GGACGACCCTT
GGGACGCCAGT -> GGACGCCAGTG
GGGAGGATAGG -> GGAGGATAGGG
GGGATACGTCT -> GGATACGTCTC
GGGATTTGGTA -> GGATTTGGTAC
GGGCCATGGTA -> GGCCATGGTAG
GGGCCCTAGAC -> GGCCCTAGACA
GGGCCGCGCCA -> GGCCGCGCCAA
GGGCGGCGGAA -> GGCGGCGGAAC
GGGCTAGCTAC -> GGCTAGCTACT
GGGCTCAGACG -> GGCTCAGACGG
GGGCTGAGGGG -> GGCTGAGGGGC
GGGCTTATATA -> GGCTTATATAG
GGGCTTCGGAA -> GGCTTCGGAAA
GGGGCCCTAGA -> GGGCCCTAGAC
GGGGCTTATAT -> GGGCTTATATA
GGGGTCCATTG -> GGGTCCATTGT
GGGTCACGATA -> GGTCACGATAC
GGGTCCATTGT -> GGTCCATTGTG
GGGTCCTCCAA -> GGTCCTCCAAA
GGGTCTAGGGT -> GGTCTAGGGTT
GGGTTAATGAT -> GGTTAATGATG
GGGTTACATTG -> GGTTACATTGA
GGTAACCTAAC -> GTAACCTAACA
GGTAACTTCGG -> GTAACTTCGGC
GGTACATGAGT -> GTACATGAGTA
GGTACGACTTC -> GTACGACTTCG
GGTACGTAGAC -> GTACGTAGACG
GGTAGCATCTT -> GTAGCATCTTG
GGTAGCATGAG -> GTAGCATGAGG
GGTAGCGGCAG -> GTAGCGGCAGG
GGTAGCTAACG -> GTAGCTAACGC
GGTAGCTATCG -> GTAGCTATCGA
GGTCAAGCCGA -> GTCAAGCCGAT
GGTCACGATAC -> GTCACGATACC
GGTCCATTGTG -> GTCCATTGTGA
GGTCCTCCAAA -> GTCCTCCAAAG
GGTCCTGCTTA -> GTCCTGCTTAA
GGTCGTCGCCA -> GTCGTCGCCAG
GGTCTAGGGTT -> GTCTAGGGTTA
GGTCTTACACT -> GTCTTACACTA
GGTCTTCGCGG -> GTCTTCGCGGA
GGTGAATAACC -> GTGAATAACCT
GGTGCGCGAAC -> GTGCGCGAACT
GGTGTCCGCGA -> GTGTCCGCGAT
GGTGTTGGAGA -> GTGTTGGAGAT
GGTTAATGATG -> GTTAATGATGG
GGTTACACCCG -> GTTACACCCGT
GGTTACATTGA -> GTTACATTGAG
GGTTACCAATC -> GTTACCAATCA
GGTTCGGTCCT -> GTTCGGTCCTG
GGTTCTGGGGC -> GTTCTGGGGCC
GGTTTCTGAAA -> GTTTCTGAAAT
GGTTTGCGCGA -> GTTTGCGCGAG
GGTTTTGAATA -> GTTTTGAATAG
GTAAAAGCAAC -> TAAAAGCAACA
GTAACCCATTT -> TAACCCATTTC
GTAACCTAACA -> TAACCTAACAT
GTAACTTCGGC -> TAACTTCGGCT
GTAAGATGTTT -> TAAGATGTTTG
GTAAGGGTTAC -> TAAGGGTTACA
GTAATGAAGAG -> TAATGAAGAGC
GTACATCGCCC -> TACATCGCCCA
GTACATGAGTA -> TACATGAGTAC
GTACCTACGGG -> TACCTACGGGC
GTACGAACTCT -> TACGAACTCTA
GTACGACTTCG -> TACGACTTCGT
GTACGATCAAC -> TACGATCAACT
GTACGTAGACG -> TACGTAGACGC
GTACTTGCTCA -> TACTTGCTCAC
GTAGAAGAGGT -> TAGAAGAGGTT
GTAGACCCGAG -> TAGACCCGAGT
GTAGACGCCAC -> TAGACGCCACA
GTAGATCCGAC -> TAGATCCGACA
GTAGCACATAG -> TAGCACATAGC
GTAGCATCTTG -> TAGCATCTTGC
GTAGCATGAGG -> TAGCATGAGGA
GTAGCGGCAGG -> TAGCGGCAGGC
GTAGCTAACGC -> TAGCTAACGCC
GTAGCTATCGA -> TAGCTATCGAA
GTAGTCTGGGT -> TAGTCTGGGTC
GTATAATGACC -> TATAATGACCT
GTATCGTATGT -> TATCGTATGTA
GTATCGTTTCT -> TATCGTTTCTC
GTATGTACGAT -> TATGTACGATC
GTCAAGCCGAT -> TCAAGCCGATT
GTCACAATATT -> TCACAATATTA
GTCACCCGGAC -> TCACCCGGACA
GTCACGATACC -> TCACGATACCC
GTCAGCTCGTG -> TCAGCTCGTGA
GTCAGTCTGTT -> TCAGTCTGTTG
GTCAGTGCTTG -> TCAGTGCTTGG
GTCATAAGGAC -> TCATAAGGACA
GTCATAGGTTC -> TCATAGGTTCT
GTCATTGAAGA -> TCATTGAAGAG
GTCCACGTGAA -> TCCACGTGAAC
GTCCATAGTCA -> TCCATAGTCAG
GTCCATTGTGA -> TCCATTGTGAT
GTCCCGGTCAA -> TCCCGGTCAAG
GTCCGCGATAT -> TCCGCGATATC
GTCCTAGTAAA -> TCCTAGTAAAA
GTCCTATCGAG -> TCCTATCGAGG
GTCCTCCAAAG -> TCCTCCAAAGG
GTCCTGCTTAA -> TCCTGCTTAAC
GTCGAAGCGAT -> TCGAAGCGATT
GTCGACACAGG -> TCGACACAGGC
GTCGCCAGGTC -> TCGCCAGGTCT
GTCGTCGCCAG -> TCGTCGCCAGG
GTCTAGGGTTA -> TCTAGGGTTAA
GTCTATGCTAC -> TCTATGCTACC
GTCTCGGTAGC -> TCTCGGTAGCA
GTCTCGTTTAA -> TCTCGTTTAAA
GTCTGGGTCCT -> TCTGGGTCCTC
GTCTGTTGATA -> TCTGTTGATAG
GTCTTACACTA -> TCTTACACTAT
GTCTTACAGCC -> TCTTACAGCCA
GTCTTCAATGC -> TCTTCAATGCT
GTCTTCGCGGA -> TCTTCGCGGAA
GTCTTGGAACG -> TCTTGGAACGG
GTCTTGTAAGA -> TCTTGTAAGAT
GTGAACCAGGT -> TGAACCAGGTA
GTGAATAACCT -> TGAATAACCTA
GTGACAATAAC -> TGACAATAACA
GTGACAGGTAC -> TGACAGGTACA
GTGACGGCTTG -> TGACGGCTTGC
GTGATATGGCT -> TGATATGGCTA
GTGCGCGAACT -> TGCGCGAACTA
GTGCGGGAAGT -> TGCGGGAAGTA
GTGCGTCTTGT -> TGCGTCTTGTA
GTGCTCCCCTG -> TGCTCCCCTGC
GTGCTTGGCTA -> TGCTTGGCTAT
GTGGACAGAGA -> TGGACAGAGAC
GTGGAGACCAC -> TGGAGACCACC
GTGGATGAACG -> TGGATGAACGA
GTGGCGCGTCT -> TGGCGCGTCTC
GTGGCTACATC -> TGGCTACATCT
GTGGGACGCCA -> TGGGACGCCAG
GTGGTCGTCGC -> TGGTCGTCGCC
GTGTAGACCCG -> TGTAGACCCGA
GTGTCCATAGT -> TGTCCATAGTC
GTGTCCGCGAT -> TGTCCGCGATA
GTGTGGCTACA -> TGTGGCTACAT
GTGTTGGAGAT -> TGTTGGAGATA
GTTAATAGCCC -> TTAATAGCCCA
GTTAATGATGG -> TTAATGATGGT
GTTACACCCGT -> TTACACCCGTG
GTTACATTGAG -> TTACATTGAGT
GTTACCAATCA -> TTACCAATCAA
GTTAGTCATTG -> TTAGTCATTGA
GTTCATGCCAC -> TTCATGCCACC
GTTCGGTCCTG -> TTCGGTCCTGC
GTTCTGGGGCC -> TTCTGGGGCCC
GTTGACTGCTC -> TTGACTGCTCG
GTTGATAGCAC -> TTGATAGCACG
GTTGCCCGGTA -> TTGCCCGGTAG
GTTGGAGATAT -> TTGGAGATATT
GTTTAAAAGTG -> TTTAAAAGTGG
GTTTCACGAGA -> TTTCACGAGAT
GTTTCTCAACT -> TTTCTCAACTG
GTTTCTGAAAT -> TTTCTGAAATA
GTTTGAAAGGT -> TTTGAAAGGTA
GTTTGCATCAT -> TTTGCATCATT
GTTTGCGCGAG -> TTTGCGCGAGA
GTTTGCTATTT -> TTTGCTATTTA
GTTTTACATCG -> TTTTACATCGC
GTTTTGAATAG -> TTTTGAATAGA
TAAAAGCAACA -> AAAAGCAACAG
TAAAAGTGGTC -> AAAAGTGGTCG
TAAACCGGTTC -> AAACCGGTTCG
TAAAGGAAGGC -> AAAGGAAGGCG
TAACAAAGACA -> AACAAAGACAT
TAACAGATCTT -> AACAGATCTTA
TAACAGGACTT -> AACAGGACTTG
TAACAGTCGAA -> AACAGTCGAAG
TAACATCCACG -> AACATCCACGC
TAACCCATTTC -> AACCCATTTCC
TAACCCGACTG -> AACCCGACTGG
TAACCTAACAT -> AACCTAACATC
TAACCTATTTA -> AACCTATTTAT
TAACGCCCATG -> AACGCCCATGC
TAACTTCGGCT -> AACTTCGGCTC
TAACTTTTAGA -> AACTTTTAGAC
TAAGATGTTTG -> AAGATGTTTGC
TAAGGACAAGA -> AAGGACAAGAG
TAAGGGTTACA -> AAGGGTTACAT
TAATAGCCCAA -> AATAGCCCAAT
TAATAGCTCTT -> AATAGCTCTTC
TAATCTCGCTT -> AATCTCGCTTT
TAATCTCTGTC -> AATCTCTGTCT
TAATGAAGAGC -> AATGAAGAGCG
TAATGACCTAG -> AATGACCTAGT
TAATGATGGTG -> AATGATGGTGC
TAATGGTGTTG -> AATGGTGTTGG
TAATGTGCGTC -> AATGTGCGTCT
TAATTATAGCT -> AATTATAGCTA
TACAAACACAA -> ACAAACACAAA
TACACACGGAG -> ACACACGGAGG
TACACCCGTGG -> ACACCCGTGGC
TACACTATAAC -> ACACTATAACA
TACAGCCACCT -> ACAGCCACCTT
TACATCGCCCA -> ACATCGCCCAT,ACATCGCCCAA
TACATCGCTCT -> ACATCGCTCTG
TACATCTCGCT -> ACATCTCGCTT
TACATGAGTAC -> ACATGAGTACT
TACATTGAGTC -> ACATTGAGTCC
TACCAATCAAG -> ACCAATCAAGA
TACCAGCGCAG -> ACCAGCGCAGA
TACCCTATATA -> ACCCTATATAG
TACCGAAATTA -> ACCGAAATTAT
TACCGATAATT -> ACCGATAATTA
TACCTACGGGC -> ACCTACGGGCT
TACCTAGTCTT -> ACCTAGTCTTG
TACCTCGGAAC -> ACCTCGGAACA
TACGAACTCTA -> ACGAACTCTAG
TACGAAGACCA -> ACGAAGACCAT
TACGACTTCGT -> ACGACTTCGTA
TACGATCAACT -> ACGATCAACTC
TACGGGCTAGC -> ACGGGCTAGCT
TACGTAGACGC -> ACGTAGACGCC
TACGTCTCGTT -> ACGTCTCGTTT
TACTCACGGGA -> ACTCACGGGAG
TACTCCGGGGT -> ACTCCGGGGTC
TACTGGTGTCC -> ACTGGTGTCCG
TACTTACTTCA -> ACTTACTTCAC
TACTTCACGCG -> ACTTCACGCGT
TACTTGCTCAC -> ACTTGCTCACA
TAGAAGAGGTT -> AGAAGAGGTTT
TAGACAGTTGA -> AGACAGTTGAC
TAGACCCGAGT -> AGACCCGAGTC
TAGACCTACAC -> AGACCTACACA
TAGACGCCACA -> AGACGCCACAG
TAGAGTCCTAT -> AGAGTCCTATC
TAGATCCGACA -> AGATCCGACAG
TAGATCCTGAA -> AGATCCTGAAC
TAGATGTCAGT -> AGATGTCAGTG
TAGCACATAGC -> AGCACATAGCT
TAGCACGCCAG -> AGCACGCCAGG
TAGCAGGAGGT -> AGCAGGAGGTC
TAGCATCTTGC -> AGCATCTTGCG
TAGCATGAGGA -> AGCATGAGGAA
TAGCCCAATCT -> AGCCCAATCTA
TAGCCCACCAT -> AGCCCACCATG
TAGCCCCGAAG -> AGCCCCGAAGT
TAGCCCCTTGT -> AGCCCCTTGTG
TAGCGGCAGGC -> AGCGGCAGGCT
TAGCGTGGATG -> AGCGTGGATGA
TAGCTAACGCC -> AGCTAACGCCC
TAGCTACTCAC -> AGCTACTCACG
TAGCTATACAT -> AGCTATACATC
TAGCTATCGAA -> AGCTATCGAAT
TAGCTCTTCTG -> AGCTCTTCTGC
TAGCTTGCTCA -> AGCTTGCTCAG
TAGGAGTCTTC -> AGGAGTCTTCA
TAGGCATTTAC -> AGGCATTTACC
TAGGGCGGCGG -> AGGGCGGCGGA
TAGGGCTGAGG -> AGGGCTGAGGG
TAGGGCTTCGG -> AGGGCTTCGGA
TAGGGTTAATG -> AGGGTTAATGA
TAGGTTCTGGG -> AGGTTCTGGGG
TAGGTTTCTGA -> AGGTTTCTGAA
TAGTAAAAGCA -> AGTAAAAGCAA
TAGTCACAATA -> AGTCACAATAT
TAGTCAGCTCG -> AGTCAGCTCGT
TAGTCATAGGT -> AGTCATAGGTT
TAGTCATTGAA -> AGTCATTGAAG
TAGTCGACACA -> AGTCGACACAG
TAGTCTGGGTC -> AGTCTGGGTCC
TAGTCTTGGAA -> AGTCTTGGAAC
TAGTGGGACGC -> AGTGGGACGCC
TATAACAGTCG -> ATAACAGTCGA
TATAATGACCT -> ATAATGACCTA
TATACAAACAC -> ATACAAACACA
TATACATCGCT -> ATACATCGCTC
TATAGCCCACC -> ATAGCCCACCA
TATAGCTATAC -> ATAGCTATACA
TATAGGCATTT -> ATAGGCATTTA
TATAGTCATAG -> ATAGTCATAGG
TATATAGGCAT -> ATATAGGCATT
TATATAGTCAT -> ATATAGTCATA
TATATCACTAG -> ATATCACTAGA
TATCAATTCAA -> ATCAATTCAAA
TATCACTAGAG -> ATCACTAGAGT
TATCCCCGCTA -> ATCCCCGCTAA
TATCCCGTAGA -> ATCCCGTAGAT
TATCGAATACT -> ATCGAATACTG
TATCGAGGAGG -> ATCGAGGAGGC
TATCGCATAGC -> ATCGCATAGCC
TATCGTATGTA -> ATCGTATGTAC
TATCGTTTCTC -> ATCGTTTCTCA
TATCTCAGTGA -> ATCTCAGTGAC
TATGAATGTTG -> ATGAATGTTGC
TATGCTACCGA -> ATGCTACCGAA
TATGGCTAGTG -> ATGGCTAGTGG
TATGTACATCG -> ATGTACATCGC
TATGTACGATC -> ATGTACGATCA
TATGTGTGGCT -> ATGTGTGGCTA
TATTAAAGGAA -> ATTAAAGGAAG
TATTAACCCGA -> ATTAACCCGAC
TATTATATCAC -> ATTATATCACT
TATTCACCGGC -> ATTCACCGGCT
TATTCGGCTTT -> ATTCGGCTTTA
TATTGTATCGT -> ATTGTATCGTT
TATTTAGATGT -> ATTTAGATGTC
TATTTATGTAC -> ATTTATGTACA
TCAAAGACGAC -> CAAAGACGACT
TCAAAGCGAAA -> CAAAGCGAAAT
TCAACTCCTTT -> CAACTCCTTTA
TCAACTGACAT -> CAACTGACATC
TCAAGAGTGAC -> CAAGAGTGACG
TCAAGCATAGT -> CAAGCATAGTC
TCAAGCCGATT -> CAAGCCGATTC
TCAAGGTACGT -> CAAGGTACGTA
TCAAGTTCATG -> CAAGTTCATGC
TCAATGCTTTA -> CAATGCTTTAG
TCAATTCAAAG -> CAATTCAAAGA
TCACAATATTA -> CACAATATTAA
TCACACGCGGA -> CACACGCGGAC
TCACCCGGACA -> CACCCGGACAG
TCACCGGCTGT -> CACCGGCTGTC
TCACGAGATGT -> CACGAGATGTA
TCACGAGCTAA -> CACGAGCTAAT
TCACGATACCC -> CACGATACCCT
TCACGCGTATA -> CACGCGTATAA
TCACGGGAGGA -> CACGGGAGGAT
TCACTAGAGTC -> CACTAGAGTCC
TCACTGCATCG -> CACTGCATCGG
TCAGACGGGCC -> CAGACGGGCCA
TCAGCAGGATC -> CAGCAGGATCA
TCAGCTCGTGA -> CAGCTCGTGAC
TCAGGCCTGTA -> CAGGCCTGTAC
TCAGTAGAAGA -> CAGTAGAAGAG
TCAGTCTGTTG -> CAGTCTGTTGA
TCAGTGACAGG -> CAGTGACAGGT
TCAGTGCTTGG -> CAGTGCTTGGC
TCAGTTTCACG -> CAGTTTCACGA
TCATAAGGACA -> CATAAGGACAA
TCATAATCTCG -> CATAATCTCGC
TCATAGGTTCT -> CATAGGTTCTG
TCATCTCGCAA -> CATCTCGCAAC
TCATGCCACCC -> CATGCCACCCG
TCATTGAAGAG -> CATTGAAGAGA
TCATTTCATAA -> CATTTCATAAT
TCCAAAGGAAT -> CCAAAGGAATC
TCCACCTCGTA -> CCACCTCGTAG
TCCACGCCCTA -> CCACGCCCTAG
TCCACGTGAAC -> CCACGTGAACC
TCCAGATGCGG -> CCAGATGCGGG
TCCATAGTCAG -> CCATAGTCAGC
TCCATTGTGAT -> CCATTGTGATA
TCCCCGCTAAT -> CCCCGCTAATC
TCCCCTGCTTT -> CCCCTGCTTTC
TCCCGGTCAAG -> CCCGGTCAAGC
TCCCGTAGATC -> CCCGTAGATCC
TCCCTTTAGCA -> CCCTTTAGCAG
TCCGACAGCCC -> CCGACAGCCCC
TCCGCGATATC -> CCGCGATATCG
TCCGGGGTCCA -> CCGGGGTCCAT
TCCTAGTAAAA -> CCTAGTAAAAG
TCCTATCGAGG -> CCTATCGAGGA
TCCTCCAAAGG -> CCTCCAAAGGA
TCCTCTCAGTA -> CCTCTCAGTAG
TCCTGAACTGC -> CCTGAACTGCC
TCCTGCTTAAC -> CCTGCTTAACA
TCCTTTACTCC -> CCTTTACTCCG
TCGAAGCGATT -> CGAAGCGATTA
TCGAATACTGG -> CGAATACTGGT
TCGACACAGGC -> CGACACAGGCA
TCGAGAGCCAC -> CGAGAGCCACA
TCGAGGAGGCG -> CGAGGAGGCGG
TCGCAACTCTC -> CGCAACTCTCA
TCGCATAGCCC -> CGCATAGCCCC
TCGCCAGGTCT -> CGCCAGGTCTT
TCGCCCAACTA -> CGCCCAACTAC
TCGCCCATTAA -> CGCCCATTAAC
TCGCGCCGTCA -> CGCGCCGTCAC
TCGCGGAATCT -> CGCGGAATCTA
TCGCTCTGGAC -> CGCTCTGGACT
TCGCTTCACTG -> CGCTTCACTGC
TCGCTTTGCAC -> CGCTTTGCACC
TCGGAAACTCT -> CGGAAACTCTT
TCGGAACAAAA -> CGGAACAAAAA
TCGGCGTTTGC -> CGGCGTTTGCA
TCGGCTCAAGC -> CGGCTCAAGCA
TCGGCTTTATT -> CGGCTTTATTA
TCGGGTCTAGG -> CGGGTCTAGGG
TCGGTAGCATG -> CGGTAGCATGA
TCGGTCCTGCT -> CGGTCCTGCTT
TCGTAACCCAT -> CGTAACCCATT
TCGTAGTCTGG -> CGTAGTCTGGG
TCGTATGTACG -> CGTATGTACGA
TCGTCGCCAGG -> CGTCGCCAGGT
TCGTCTATGCT -> CGTCTATGCTA
TCGTGACAATA -> CGTGACAATAA
TCGTTTAAAAG -> CGTTTAAAAGT
TCGTTTCTCAA -> CGTTTCTCAAC
TCTACCAGCGC -> CTACCAGCGCA
TCTACCTAGTC -> CTACCTAGTCT
TCTAGGAGTCT -> CTAGGAGTCTT
TCTAGGGTTAA -> CTAGGGTTAAT
TCTATCTCAGT -> CTATCTCAGTG
TCTATGCTACC -> CTATGCTACCG
TCTATTCGGCT -> CTATTCGGCTT
TCTCAACTGAC -> CTCAACTGACA
TCTCAGGCCTG -> CTCAGGCCTGT
TCTCAGTAGAA -> CTCAGTAGAAG
TCTCAGTGACA -> CTCAGTGACAG
TCTCGCAACTC -> CTCGCAACTCT
TCTCGCTTCAC -> CTCGCTTCACT
TCTCGCTTTGC -> CTCGCTTTGCA
TCTCGGTAGCA -> CTCGGTAGCAT
TCTCGTTTAAA -> CTCGTTTAAAA
TCTCTGTCTTA -> CTCTGTCTTAC
TCTGAAATAGG -> CTGAAATAGGG
TCTGCGCCTGT -> CTGCGCCTGTG
TCTGCTGGACC -> CTGCTGGACCA
TCTGGACTGGT -> CTGGACTGGTA
TCTGGGGCCCT -> CTGGGGCCCTA
TCTGGGTCCTC -> CTGGGTCCTCC
TCTGTCTTACA -> CTGTCTTACAG
TCTGTTGATAG -> CTGTTGATAGC
TCTTACACTAT -> CTTACACTATA
TCTTACAGCCA -> CTTACAGCCAC
TCTTATAGCCC -> CTTATAGCCCA
TCTTATCCCGT -> CTTATCCCGTA
TCTTATTATAT -> CTTATTATATC
TCTTCAATGCT -> CTTCAATGCTT
TCTTCCCTTTA -> CTTCCCTTTAG
TCTTCGCGGAA -> CTTCGCGGAAT
TCTTCTGCGCC -> CTTCTGCGCCT
TCTTGCGGTTT -> CTTGCGGTTTT
TCTTGGAACGG -> CTTGGAACGGT
TCTTGTAAGAT -> CTTGTAAGATG
TGAAAGGTAGC -> GAAAGGTAGCG
TGAAATAGGGC -> GAAATAGGGCT
TGAACCAGGTA -> GAACCAGGTAA
TGAACGAAACG -> GAACGAAACGC
TGAACTGCCGA -> GAACTGCCGAT
TGAAGAGAATC -> GAAGAGAATCT
TGAAGAGCGAT -> GAAGAGCGATA
TGAATAACCTA -> GAATAACCTAT
TGAATAGATCC -> GAATAGATCCT
TGAATGTTGCC -> GAATGTTGCCC
TGACAATAACA -> GACAATAACAG
TGACAGGTACA -> GACAGGTACAT
TGACATCTATT -> GACATCTATTC
TGACCAAGCCG -> GACCAAGCCGG
TGACCTAGTCA -> GACCTAGTCAC
TGACGGCTTGC -> GACGGCTTGCA
TGACGTCCCGG -> GACGTCCCGGT
TGACTGCTCGT -> GACTGCTCGTC
TGAGAATATTG -> GAGAATATTGT
TGAGGAACCCG -> GAGGAACCCGG
TGAGGCTACGA -> GAGGCTACGAA
TGAGGGGCTTA -> GAGGGGCTTAT
TGAGTACTTGC -> GAGTACTTGCT
TGAGTCCTAGT -> GAGTCCTAGTA
TGATAACAGAT -> GATAACAGATC
TGATAGCACGC -> GATAGCACGCC
TGATATGGCTA -> GATATGGCTAG
TGATGGTGCGC -> GATGGTGCGCG
TGATTACTTAC -> GATTACTTACT
TGCACCGGTTA -> GCACCGGTTAC
TGCAGAGCTGT -> GCAGAGCTGTT
TGCATCATTTC -> GCATCATTTCA
TGCATCGGCGT -> GCATCGGCGTT
TGCATCGGGTC -> GCATCGGGTCT
TGCCACCCGCC -> GCCACCCGCCT
TGCCCGGTAGC -> GCCCGGTAGCA
TGCCGATGAGG -> GCCGATGAGGC
TGCGCCTGTGT -> GCGCCTGTGTC
TGCGCGAACTA -> GCGCGAACTAG
TGCGCGAGACT -> GCGCGAGACTT
TGCGGGAAGTA -> GCGGGAAGTAA
TGCGGGCTCAG -> GCGGGCTCAGA
TGCGGTTTTGA -> GCGGTTTTGAA
TGCGTCTTGTA -> GCGTCTTGTAA
TGCTACCGAAA -> GCTACCGAAAT
TGCTATTTAGA -> GCTATTTAGAT
TGCTCACACGC -> GCTCACACGCG
TGCTCAGTTTC -> GCTCAGTTTCA
TGCTCCCCTGC -> GCTCCCCTGCT
TGCTCGTCTAT -> GCTCGTCTATG
TGCTGAGAATA -> GCTGAGAATAT
TGCTGGACCAA -> GCTGGACCAAA
TGCTTAACAAA -> GCTTAACAAAG
TGCTTGGCTAT -> GCTTGGCTATA
TGCTTTAGCCC -> GCTTTAGCCCC
TGCTTTCATCT -> GCTTTCATCTC
TGGAACGGTTA -> GGAACGGTTAC
TGGACAGAGAC -> GGACAGAGACA
TGGACCAAACA -> GGACCAAACAC
TGGACTGGTAA -> GGACTGGTAAC
TGGAGACCACC -> GGAGACCACCC
TGGAGATATTC -> GGAGATATTCA
TGGATGAACGA -> GGATGAACGAA
TGGCATCACGA -> GGCATCACGAG
TGGCGCGTCTC -> GGCGCGTCTCG
TGGCTACATCT -> GGCTACATCTC
TGGCTAGTGGG -> GGCTAGTGGGA
TGGCTATACAA -> GGCTATACAAA
TGGCTCGAGAG -> GGCTCGAGAGC
TGGGACGACCC -> GGGACGACCCT
TGGGACGCCAG -> GGGACGCCAGT
TGGGATACGTC -> GGGATACGTCT
TGGGGCCCTAG -> GGGGCCCTAGA
TGGGTCACGAT -> GGGTCACGATA
TGGGTCCTCCA -> GGGTCCTCCAA
TGGTAACTTCG -> GGTAACTTCGG
TGGTACGACTT -> GGTACGACTTC
TGGTAGCTATC -> GGTAGCTATCG
TGGTCGTCGCC -> GGTCGTCGCCA
TGGTGAATAAC -> GGTGAATAACC
TGGTGCGCGAA -> GGTGCGCGAAC
TGGTGTCCGCG -> GGTGTCCGCGA
TGGTGTTGGAG -> GGTGTTGGAGA
TGTAAGATGTT -> GTAAGATGTTT
TGTAATGAAGA -> GTAATGAAGAG
TGTACATCGCC -> GTACATCGCCC
TGTACCTACGG -> GTACCTACGGG
TGTACGAACTC -> GTACGAACTCT
TGTACGATCAA -> GTACGATCAAC
TGTAGACCCGA -> GTAGACCCGAG
TGTATCGTATG -> GTATCGTATGT
TGTATCGTTTC -> GTATCGTTTCT
TGTCAGTGCTT -> GTCAGTGCTTG
TGTCATAAGGA -> GTCATAAGGAC
TGTCCATAGTC -> GTCCATAGTCA
TGTCCGCGATA -> GTCCGCGATAT
TGTCTTACAGC -> GTCTTACAGCC
TGTGATATGGC -> GTGATATGGCT
TGTGCGGGAAG -> GTGCGGGAAGT
TGTGCGTCTTG -> GTGCGTCTTGT
TGTGGAGACCA -> GTGGAGACCAC
TGTGGCTACAT -> GTGGCTACATC
TGTGTCCATAG -> GTGTCCATAGT
TGTGTGGCTAC -> GTGTGGCTACA
TGTTGATAGCA -> GTTGATAGCAC
TGTTGCCCGGT -> GTTGCCCGGTA
TGTTGGAGATA -> GTTGGAGATAT
TGTTTGAAAGG -> GTTTGAAAGGT
TGTTTGCTATT -> GTTTGCTATTT
TTAAAAGTGGT -> TAAAAGTGGTC
TTAAACCGGTT -> TAAACCGGTTC
TTAAAGGAAGG -> TAAAGGAAGGC
TTAACAAAGAC -> TAACAAAGACA
TTAACCCGACT -> TAACCCGACTG
TTAACTTTTAG -> TAACTTTTAGA
TTAATAGCCCA -> TAATAGCCCAA
TTAATGATGGT -> TAATGATGGTG
TTAATGGTGTT -> TAATGGTGTTG
TTAATGTGCGT -> TAATGTGCGTC
TTACACCCGTG -> TACACCCGTGG
TTACACTATAA -> TACACTATAAC
TTACAGCCACC -> TACAGCCACCT
TTACATCGCCC -> TACATCGCCCA
TTACATTGAGT -> TACATTGAGTC
TTACCAATCAA -> TACCAATCAAG
TTACCGATAAT -> TACCGATAATT
TTACTCCGGGG -> TACTCCGGGGT
TTACTTACTTC -> TACTTACTTCA
TTACTTCACGC -> TACTTCACGCG
TTAGACCTACA -> TAGACCTACAC
TTAGATGTCAG -> TAGATGTCAGT
TTAGCAGGAGG -> TAGCAGGAGGT
TTAGCCCCGAA -> TAGCCCCGAAG
TTAGGTTTCTG -> TAGGTTTCTGA
TTAGTCATTGA -> TAGTCATTGAA
TTATAGCCCAC -> TATAGCCCACC
TTATAGCTATA -> TATAGCTATAC
TTATATAGGCA -> TATATAGGCAT
TTATATCACTA -> TATATCACTAG
TTATCCCGTAG -> TATCCCGTAGA
TTATGTACATC -> TATGTACATCG
TTATGTGTGGC -> TATGTGTGGCT
TTATTAAAGGA -> TATTAAAGGAA
TTATTATATCA -> TATTATATCAC
TTCAAAGACGA -> TCAAAGACGAC
TTCAAGTTCAT -> TCAAGTTCATG
TTCAATGCTTT -> TCAATGCTTTA
TTCACCGGCTG -> TCACCGGCTGT
TTCACGAGATG -> TCACGAGATGT
TTCACGCGTAT -> TCACGCGTATA
TTCACTGCATC -> TCACTGCATCG
TTCATAATCTC -> TCATAATCTCG
TTCATCTCGCA -> TCATCTCGCAA
TTCATGCCACC -> TCATGCCACCC
TTCCAGATGCG -> TCCAGATGCGG
TTCCCTTTAGC -> TCCCTTTAGCA
TTCCTCTCAGT -> TCCTCTCAGTA
TTCGCGGAATC -> TCGCGGAATCT
TTCGGAAACTC -> TCGGAAACTCT
TTCGGCTCAAG -> TCGGCTCAAGC
TTCGGCTTTAT -> TCGGCTTTATT
TTCGGTCCTGC -> TCGGTCCTGCT
TTCGTAACCCA -> TCGTAACCCAT
TTCTATCTCAG -> TCTATCTCAGT
TTCTCAACTGA -> TCTCAACTGAC
TTCTGAAATAG -> TCTGAAATAGG
TTCTGCGCCTG -> TCTGCGCCTGT
TTCTGGGGCCC -> TCTGGGGCCCT
TTGAAAGGTAG -> TGAAAGGTAGC
TTGAAGAGAAT -> TGAAGAGAATC
TTGAATAGATC -> TGAATAGATCC
TTGACGTCCCG -> TGACGTCCCGG
TTGACTGCTCG -> TGACTGCTCGT
TTGAGTCCTAG -> TGAGTCCTAGT
TTGATAACAGA -> TGATAACAGAT
TTGATAGCACG -> TGATAGCACGC
TTGATTACTTA -> TGATTACTTAC
TTGCACCGGTT -> TGCACCGGTTA
TTGCAGAGCTG -> TGCAGAGCTGT
TTGCATCATTT -> TGCATCATTTC
TTGCCCGGTAG -> TGCCCGGTAGC
TTGCGCGAGAC -> TGCGCGAGACT
TTGCGGTTTTG -> TGCGGTTTTGA
TTGCTATTTAG -> TGCTATTTAGA
TTGCTCACACG -> TGCTCACACGC
TTGCTCAGTTT -> TGCTCAGTTTC
TTGGAACGGTT -> TGGAACGGTTA
TTGGAGATATT -> TGGAGATATTC
TTGGCTATACA -> TGGCTATACAA
TTGGCTCGAGA -> TGGCTCGAGAG
TTGGTACGACT -> TGGTACGACTT
TTGTAAGATGT -> TGTAAGATGTT
TTGTACGAACT -> TGTACGAACTC
TTGTATCGTTT -> TGTATCGTTTC
TTGTGATATGG -> TGTGATATGGC
TTGTGCGGGAA -> TGTGCGGGAAG
TTTAAAAGTGG -> TTAAAAGTGGT
TTTACATCGCC -> TTACATCGCCC
TTTACCGATAA -> TTACCGATAAT
TTTACTCCGGG -> TTACTCCGGGG
TTTAGACCTAC -> TTAGACCTACA
TTTAGATGTCA -> TTAGATGTCAG
TTTAGCAGGAG -> TTAGCAGGAGG
TTTAGCCCCGA -> TTAGCCCCGAA
TTTATGTACAT -> TTATGTACATC
TTTATTAAAGG -> TTATTAAAGGA
TTTCACGAGAT -> TTCACGAGATG
TTTCATAATCT -> TTCATAATCTC
TTTCATCTCGC -> TTCATCTCGCA
TTTCCTCTCAG -> TTCCTCTCAGT
TTTCTCAACTG -> TTCTCAACTGA
TTTCTGAAATA -> TTCTGAAATAG
TTTGAAAGGTA -> TTGAAAGGTAG
TTTGAATAGAT -> TTGAATAGATC
TTTGATAACAG -> TTGATAACAGA
TTTGCACCGGT -> TTGCACCGGTT
TTTGCATCATT -> TTGCATCATTT
TTTGCGCGAGA -> TTGCGCGAGAC
TTTGCTATTTA -> TTGCTATTTAG
TTTGGCTCGAG -> TTGGCTCGAGA
TTTGGTACGAC -> TTGGTACGACT
TTTTACATCGC -> TTTACATCGCC
TTTTAGACCTA -> TTTAGACCTAC
TTTTGAATAGA -> TTTGAATAGAT
